nameOfIssuer	titleOfClass	cusip	value	sshPrnamt	sshPrnamtType	investmentDiscretion	Sole	Shared	None
AFLAC INC COM	COM	001055102	21319	296629	SH	SOLE	296629	0	0
AES CORP COM	COM	00130H105	14555	1132700	SH	SOLE	1132700	0	0
AK STL CORP NOTE 5.000%11/1	CV	001546AP5	5407	4501000	PRN	SOLE	4501000	0	0
AMC NETWORKS INC CL A	COM	00164V103	47704	919863	SH	SOLE	867480	0	52383
ATT INC COM	COM	00206R102	283804	6988534	SH	SOLE	6900120	0	88414
ATT INC COM	COM	00206R102	97	2378	SH	OTR	0	0	2378
AZZ INC COM	COM	002474104	2350	36000	SH	SOLE	36000	0	0
ABBOTT LABS COM	COM	002824100	123459	2919347	SH	SOLE	2836587	0	82760
ABBOTT LABS COM	COM	002824100	109	2575	SH	OTR	0	0	2575
ABBVIE INC COM	COM	00287Y109	28792	456506	SH	SOLE	456506	0	0
ABIOMED INC COM	COM	003654100	110740	861257	SH	SOLE	849450	0	11807
ACACIA COMMUNICATIONS INC COM	COM	00401C108	25532	247208	SH	SOLE	240831	0	6377
ACADIA HEALTHCARE COMPANY IN COM	COM	00404A109	2914	58809	SH	SOLE	58809	0	0
ACADIA PHARMACEUTICALS INC COM	COM	004225108	37068	1165284	SH	SOLE	1152145	0	13139
ACCELERON PHARMA INC COM	COM	00434H108	4788	132303	SH	SOLE	132303	0	0
ACCELERON PHARMA INC COM	COM	00434H108	1113	30742	SH	OTR	30742	0	0
ACTIVISION BLIZZARD INC COM	COM	00507V109	13041	294379	SH	SOLE	294379	0	0
ACUITY BRANDS INC COM	COM	00508Y102	10944	41361	SH	SOLE	41361	0	0
ACXIOM CORP COM	COM	005125109	84074	3154753	SH	SOLE	2975842	0	178911
ADOBE SYS INC COM	COM	00724F101	33126	305196	SH	SOLE	305196	0	0
AECOM COM	COM	00766T100	104938	3529692	SH	SOLE	3319496	0	210196
ADVANCED MICRO DEVICES INC NOTE 2.125% 9/0	CV	007903BD8	7343	6737000	PRN	SOLE	6737000	0	0
ADVANCED DRAIN SYS INC DEL COM	COM	00790R104	19530	811741	SH	SOLE	811741	0	0
AFFILIATED MANAGERS GROUP COM	COM	008252108	5201	35946	SH	SOLE	33546	0	2400
AGILENT TECHNOLOGIES INC COM	COM	00846U101	34428	731102	SH	SOLE	731102	0	0
AGIOS PHARMACEUTICALS INC COM	COM	00847X104	26857	508469	SH	SOLE	495553	0	12916
AIR LEASE CORP CL A	COM	00912X302	9431	330000	SH	SOLE	330000	0	0
AIR PRODS  CHEMS INC COM	COM	009158106	19454	129400	SH	SOLE	129400	0	0
AIR TRANSPORT SERVICES GRP I COM	COM	00922R105	5811	404952	SH	SOLE	404952	0	0
AIR TRANSPORT SERVICES GRP I COM	COM	00922R105	1348	93930	SH	OTR	93930	0	0
AKAMAI TECHNOLOGIES INC COM	COM	00971T101	58921	1111929	SH	SOLE	1047265	0	64664
ALARM COM HLDGS INC COM	COM	011642105	5949	206127	SH	SOLE	206127	0	0
ALARM COM HLDGS INC COM	COM	011642105	1378	47759	SH	OTR	47759	0	0
ALASKA AIR GROUP INC COM	COM	011659109	26696	405343	SH	SOLE	405343	0	0
ALBEMARLE CORP COM	COM	012653101	59766	699105	SH	SOLE	699105	0	0
ALERE INC COM	COM	01449J105	168735	3902295	SH	SOLE	3724402	0	177893
ALEXANDRIA REAL ESTATE EQ IN COM	COM	015271109	37980	349173	SH	SOLE	349173	0	0
ALIBABA GROUP HLDG LTD SPONSORED ADS	ADR	01609W102	37041	350135	SH	SOLE	349465	0	670
ALIBABA GROUP HLDG LTD SPONSORED ADS	ADR	01609W102	6	55	SH	OTR	0	0	55
ALIGN TECHNOLOGY INC COM	COM	016255101	41558	443281	SH	SOLE	443281	0	0
ALLEGHENY TECHNOLOGIES INC NOTE 4.750% 7/0	CV	01741RAG7	1416	1000000	PRN	SOLE	1000000	0	0
ALLISON TRANSMISSION HLDGS I COM	COM	01973R101	1844	64300	SH	SOLE	64300	0	0
ALLSTATE CORP COM	COM	020002101	63589	919179	SH	SOLE	919179	0	0
ALPHABET INC CAP STK CL A	COM	02079K305	113417	141055	SH	SOLE	141055	0	0
ALTRIA GROUP INC COM	COM	02209S103	85967	1359591	SH	SOLE	1359591	0	0
ALZA CORP SDCV 7/2	CV	02261WAB5	260	160000	PRN	SOLE	160000	0	0
AMAZON COM INC COM	COM	023135106	143467	171343	SH	SOLE	171343	0	0
AMBER RD INC COM	COM	02318Y108	3035	314523	SH	SOLE	314523	0	0
AMBER RD INC COM	COM	02318Y108	704	72910	SH	OTR	72910	0	0
AMERICAN EAGLE OUTFITTERS NE COM	COM	02553E106	15977	894550	SH	SOLE	894550	0	0
AMERICAN EXPRESS CO COM	COM	025816109	2799	43700	SH	SOLE	43700	0	0
AMERICAN HOMES 4 RENT CL A	COM	02665T306	3577	165300	SH	SOLE	165300	0	0
AMERICAN RLTY CAP PPTYS INC NOTE 3.000% 8/0	CV	02917TAA2	28514	28550000	PRN	SOLE	28550000	0	0
AMERICAN TOWER CORP NEW COM	COM	03027X100	10798	95277	SH	SOLE	95277	0	0
AMERICAN TOWER CORP NEW PFD CONV SER A	CVPFD	03027X308	11254	101492	SH	SOLE	101492	0	0
AMERICAN TOWER CORP NEW DEP PFD CONV SE	CVPFD	03027X407	10797	98518	SH	SOLE	98518	0	0
AMERICAN WTR WKS CO INC NEW COM	COM	030420103	59211	791171	SH	SOLE	742433	0	48738
AMERISAFE INC COM	COM	03071H100	3643	61970	SH	SOLE	61970	0	0
AMERISOURCEBERGEN CORP COM	COM	03073E105	12755	157900	SH	SOLE	157900	0	0
AMERIPRISE FINL INC COM	COM	03076C106	78529	787100	SH	SOLE	787100	0	0
AMERIS BANCORP COM	COM	03076K108	3243	92800	SH	SOLE	92800	0	0
AMPHENOL CORP NEW CL A	COM	032095101	40704	626987	SH	SOLE	578128	0	48859
AMPLIFY SNACK BRANDS COM	COM	03211L102	22503	1389096	SH	SOLE	1389096	0	0
AMPLIFY SNACK BRANDS COM	COM	03211L102	1036	63948	SH	OTR	63948	0	0
AMTRUST FINL SVCS INC COM	COM	032359309	28400	1058500	SH	SOLE	1058500	0	0
AMTRUST FINL SVCS INC NOTE 2.750%12/1	CV	032359AG6	5108	5855000	PRN	SOLE	5855000	0	0
ANADARKO PETE CORP COM	COM	032511107	2629	41500	SH	SOLE	41500	0	0
ANNALY CAP MGMT INC COM	COM	035710409	12918	1230300	SH	SOLE	1230300	0	0
ANTERO RES CORP COM	COM	03674X106	16790	622996	SH	SOLE	622996	0	0
ANTHEM INC COM	COM	036752103	36528	291500	SH	SOLE	291500	0	0
ANTHEM INC UNIT 05/01/20188	CVPFD	036752202	6373	146601	SH	SOLE	146601	0	0
APPLE INC COM	COM	037833100	181307	1603779	SH	SOLE	1603779	0	0
APPLIED MATLS INC COM	COM	038222105	84279	2795311	SH	SOLE	2795311	0	0
APPLIED MICRO CIRCUITS CORP COM NEW	COM	03822W406	6472	931176	SH	SOLE	931176	0	0
APPLIED MICRO CIRCUITS CORP COM NEW	COM	03822W406	1500	215856	SH	OTR	215856	0	0
APTARGROUP INC COM	COM	038336103	19848	256400	SH	SOLE	256400	0	0
APPTIO INC CL A	COM	03835C108	3348	154291	SH	SOLE	154291	0	0
APPTIO INC CL A	COM	03835C108	775	35709	SH	OTR	35709	0	0
AQUA AMERICA INC COM	COM	03836W103	10683	350490	SH	SOLE	350490	0	0
ARAMARK COM	COM	03852U106	90824	2388222	SH	SOLE	2271974	0	116248
ARGAN INC COM	COM	04010E109	6620	111848	SH	SOLE	111848	0	0
ARGAN INC COM	COM	04010E109	788	13315	SH	OTR	13315	0	0
ARES CAP CORP NOTE 4.875% 3/1	CV	04010LAG8	3468	3421000	PRN	SOLE	3421000	0	0
ARIAD PHARMACEUTICALS INC COM	COM	04033A100	34808	2542618	SH	SOLE	2509611	0	33007
ARISTA NETWORKS INC COM	COM	040413106	17215	202338	SH	SOLE	202338	0	0
ATKORE INTL GROUP INC COM	COM	047649108	17707	944866	SH	SOLE	944866	0	0
ATMOS ENERGY CORP COM	COM	049560105	34725	466300	SH	SOLE	466300	0	0
AUTOMATIC DATA PROCESSING IN COM	COM	053015103	20074	227600	SH	SOLE	227600	0	0
AUTOZONE INC COM	COM	053332102	12222	15907	SH	SOLE	15907	0	0
AVALONBAY CMNTYS INC COM	COM	053484101	79041	444450	SH	SOLE	444450	0	0
AVERY DENNISON CORP COM	COM	053611109	29848	383700	SH	SOLE	383700	0	0
BBT CORP COM	COM	054937107	62462	1655949	SH	SOLE	1655949	0	0
BNC BANCORP COM	COM	05566T101	4548	187000	SH	SOLE	187000	0	0
BWX TECHNOLOGIES INC COM	COM	05605H100	6941	180900	SH	SOLE	180900	0	0
BALL CORP COM	COM	058498106	9939	121284	SH	SOLE	121284	0	0
BANCO BILBAO VIZCAYA ARGENTA SPONSORED ADR	ADR	05946K101	73	12267	SH	SOLE	7125	0	5142
BANCO BILBAO VIZCAYA ARGENTA SPONSORED ADR	ADR	05946K101	4	645	SH	OTR	0	0	645
BANK AMER CORP COM	COM	060505104	25015	1598380	SH	SOLE	1558396	0	39984
BANK AMER CORP COM	COM	060505104	30	1933	SH	OTR	0	0	1933
BANK HAWAII CORP COM	COM	062540109	68502	943299	SH	SOLE	872781	0	70518
BARD C R INC COM	COM	067383109	36596	163172	SH	SOLE	163172	0	0
B/E AEROSPACE INC COM	COM	073302101	33465	647790	SH	SOLE	640892	0	6898
BEACON ROOFING SUPPLY INC COM	COM	073685109	85049	2021599	SH	SOLE	1982303	0	39296
BECTON DICKINSON  CO COM	COM	075887109	13138	73100	SH	SOLE	73100	0	0
BELDEN INC COM	COM	077454106	106382	1541987	SH	SOLE	1472147	0	69840
BENEFITFOCUS INC COM	COM	08180D106	44543	1115803	SH	SOLE	1089064	0	26739
BENEFITFOCUS INC COM	COM	08180D106	1135	28436	SH	OTR	28436	0	0
BERKSHIRE HATHAWAY INC DEL CL B NEW	COM	084670702	4753	32900	SH	SOLE	32900	0	0
BERRY PLASTICS GROUP INC COM	COM	08579W103	75196	1714848	SH	SOLE	1618874	0	95974
BIOMARIN PHARMACEUTICAL INC COM	COM	09061G101	24278	262403	SH	SOLE	262403	0	0
BIOMARIN PHARMACEUTICAL INC NOTE 1.500%10/1	CV	09061GAF8	11953	9548000	PRN	SOLE	9548000	0	0
BIOGEN INC COM	COM	09062X103	22570	72102	SH	SOLE	72102	0	0
BIO TECHNE CORP COM	COM	09073M104	26105	238398	SH	SOLE	235240	0	3158
BLACK HILLS CORP COM	COM	092113109	80943	1322172	SH	SOLE	1255928	0	66244
BLACK HILLS CORP UNIT 99/99/9999	CVPFD	092113125	34963	507000	SH	SOLE	507000	0	0
BLACKROCK INC COM	COM	09247X101	25517	70400	SH	SOLE	70400	0	0
BLUE BUFFALO PET PRODS INC COM	COM	09531U102	37874	1594041	SH	SOLE	1569855	0	24186
BLUEPRINT MEDICINES CORP COM	COM	09627Y109	6804	229075	SH	SOLE	229075	0	0
BLUEPRINT MEDICINES CORP COM	COM	09627Y109	1581	53228	SH	OTR	53228	0	0
BOEING CO COM	COM	097023105	105208	798600	SH	SOLE	798600	0	0
BOISE CASCADE CO DEL COM	COM	09739D100	10302	405590	SH	SOLE	405590	0	0
BOOZ ALLEN HAMILTON HLDG COR CL A	COM	099502106	102956	3257057	SH	SOLE	3048415	0	208642
BOSTON PROPERTIES INC COM	COM	101121101	106390	780618	SH	SOLE	766996	0	13622
BOSTON PROPERTIES INC COM	COM	101121101	33	242	SH	OTR	0	0	242
BOSTON SCIENTIFIC CORP COM	COM	101137107	28338	1190686	SH	SOLE	1190686	0	0
BOYD GAMING CORP COM	COM	103304101	11163	564371	SH	SOLE	564371	0	0
BRINKER INTL INC COM	COM	109641100	27237	540100	SH	SOLE	540100	0	0
BRISTOL MYERS SQUIBB CO COM	COM	110122108	38719	718079	SH	SOLE	718079	0	0
BRIXMOR PPTY GROUP INC COM	COM	11120U105	29897	1075816	SH	SOLE	1075816	0	0
BROADSOFT INC COM	COM	11133B409	53143	1141633	SH	SOLE	1113191	0	28442
BROADSOFT INC COM	COM	11133B409	1207	25919	SH	OTR	25919	0	0
BROWN  BROWN INC COM	COM	115236101	9220	244500	SH	SOLE	244500	0	0
BROWN FORMAN CORP CL B	COM	115637209	4084	86094	SH	SOLE	86094	0	0
BUILDERS FIRSTSOURCE INC COM	COM	12008R107	45056	3914522	SH	SOLE	3823167	0	91355
BUILDERS FIRSTSOURCE INC COM	COM	12008R107	987	85781	SH	OTR	85781	0	0
BURLINGTON STORES INC COM	COM	122017106	81922	1011129	SH	SOLE	997107	0	14022
CBOE HLDGS INC COM	COM	12503M108	9439	145558	SH	SOLE	145558	0	0
CBRE GROUP INC CL A	COM	12504L109	5660	202273	SH	SOLE	202273	0	0
CIGNA CORPORATION COM	COM	125509109	5330	40900	SH	SOLE	40900	0	0
CIT GROUP INC COM NEW	COM	125581801	37846	1042587	SH	SOLE	1042587	0	0
CMS ENERGY CORP COM	COM	125896100	81924	1950097	SH	SOLE	1802318	0	147779
CSX CORP COM	COM	126408103	105188	3448778	SH	SOLE	3353631	0	95147
CSX CORP COM	COM	126408103	100	3290	SH	OTR	0	0	3290
CSRA INC COM	COM	12650T104	45135	1677894	SH	SOLE	1677894	0	0
CVS HEALTH CORP COM	COM	126650100	99996	1123678	SH	SOLE	1103304	0	20374
CVS HEALTH CORP COM	COM	126650100	58	657	SH	OTR	0	0	657
CA INC COM	COM	12673P105	9246	279500	SH	SOLE	279500	0	0
CALAVO GROWERS INC COM	COM	128246105	29260	447201	SH	SOLE	436926	0	10275
CALAVO GROWERS INC COM	COM	128246105	801	12235	SH	OTR	12235	0	0
CALLIDUS SOFTWARE INC COM	COM	13123E500	18008	981352	SH	SOLE	959835	0	21517
CALLIDUS SOFTWARE INC COM	COM	13123E500	718	39135	SH	OTR	39135	0	0
CALLON PETE CO DEL COM	COM	13123X102	17263	1099524	SH	SOLE	1099524	0	0
CAMDEN PPTY TR SH BEN INT	COM	133131102	9111	108800	SH	SOLE	108800	0	0
CANTEL MEDICAL CORP COM	COM	138098108	11631	149150	SH	SOLE	149150	0	0
CAPITAL ONE FINL CORP COM	COM	14040H105	7463	103900	SH	SOLE	103900	0	0
CARDINAL HEALTH INC COM	COM	14149Y108	74828	963042	SH	SOLE	963042	0	0
CARRIZO OIL  GAS INC COM	COM	144577103	66105	1627407	SH	SOLE	1551125	0	76282
CARTER INC COM	COM	146229109	4906	56584	SH	SOLE	56584	0	0
CATERPILLAR INC DEL COM	COM	149123101	55563	625924	SH	SOLE	604398	0	21526
CATERPILLAR INC DEL COM	COM	149123101	61	690	SH	OTR	0	0	690
CAVCO INDS INC DEL COM	COM	149568107	6271	63310	SH	SOLE	63310	0	0
CAVCO INDS INC DEL COM	COM	149568107	1453	14668	SH	OTR	14668	0	0
CELANESE CORP DEL COM SER A	COM	150870103	47670	716200	SH	SOLE	716200	0	0
CELGENE CORP COM	COM	151020104	49777	476201	SH	SOLE	464816	0	11385
CELGENE CORP COM	COM	151020104	55	524	SH	OTR	0	0	524
CENTENE CORP DEL COM	COM	15135B101	13909	207723	SH	SOLE	207723	0	0
CENTURYLINK INC COM	COM	156700106	6468	235800	SH	SOLE	235800	0	0
CEPHEID DBCV 1.250% 2/0	CV	15670RAC1	6466	6214000	PRN	SOLE	6214000	0	0
CEVA INC COM	COM	157210105	12964	369655	SH	SOLE	369655	0	0
CEVA INC COM	COM	157210105	1765	50339	SH	OTR	50339	0	0
CHARLES RIV LABS INTL INC COM	COM	159864107	28829	345921	SH	SOLE	340470	0	5451
CHART INDS INC NOTE 2.000% 8/0	CV	16115QAC4	4148	4200000	PRN	SOLE	4200000	0	0
CHASE CORP COM	COM	16150R104	4534	65600	SH	SOLE	65600	0	0
CHEESECAKE FACTORY INC COM	COM	163072101	11714	234000	SH	SOLE	234000	0	0
CHEGG INC COM	COM	163092109	3326	469048	SH	SOLE	469048	0	0
CHEGG INC COM	COM	163092109	766	108053	SH	OTR	108053	0	0
CHEMICAL FINL CORP COM	COM	163731102	60217	1364542	SH	SOLE	1314834	0	49708
CHENIERE ENERGY INC COM NEW	COM	16411R208	3789	86900	SH	SOLE	86900	0	0
CHESAPEAKE ENERGY CORP COM	COM	165167107	1379	220000	SH	SOLE	220000	0	0
CHESAPEAKE ENERGY CORP NOTE 2.500% 5/1	CV	165167BZ9	6829	6803000	PRN	SOLE	6803000	0	0
CHESAPEAKE ENERGY CORP NOTE 2.500% 5/1	CV	165167CA3	1581	1575000	PRN	SOLE	1575000	0	0
CHESAPEAKE UTILS CORP COM	COM	165303108	4335	71000	SH	SOLE	71000	0	0
CHEVRON CORP NEW COM	COM	166764100	321172	3120602	SH	SOLE	3120602	0	0
CHURCH  DWIGHT INC COM	COM	171340102	6000	125207	SH	SOLE	125207	0	0
CIMAREX ENERGY CO COM	COM	171798101	114647	853217	SH	SOLE	826584	0	26633
CIRRUS LOGIC INC COM	COM	172755100	59401	1117619	SH	SOLE	1088846	0	28773
CISCO SYS INC COM	COM	17275R102	162270	5115690	SH	SOLE	5009365	0	106325
CISCO SYS INC COM	COM	17275R102	95	2985	SH	OTR	0	0	2985
CITIGROUP INC COM NEW	COM	172967424	12091	256000	SH	SOLE	256000	0	0
CITIZENS FINL GROUP INC COM	COM	174610105	349317	14136676	SH	SOLE	13777776	0	358900
CITIZENS FINL GROUP INC COM	COM	174610105	179	7233	SH	OTR	0	0	7233
CLARCOR INC COM	COM	179895107	6637	102100	SH	SOLE	102100	0	0
CLOVIS ONCOLOGY INC COM	COM	189464100	3803	105487	SH	SOLE	105487	0	0
CLOVIS ONCOLOGY INC COM	COM	189464100	878	24367	SH	OTR	24367	0	0
CLUBCORP HLDGS INC COM	COM	18948M108	3166	218796	SH	SOLE	218796	0	0
CLUBCORP HLDGS INC COM	COM	18948M108	734	50694	SH	OTR	50694	0	0
COACH INC COM	COM	189754104	5096	139400	SH	SOLE	139400	0	0
COCA COLA CO COM	COM	191216100	70507	1666047	SH	SOLE	1666047	0	0
COGENT COMMUNICATIONS HLDGS COM NEW	COM	19239V302	27886	757562	SH	SOLE	748050	0	9512
COGNEX CORP COM	COM	192422103	29731	562447	SH	SOLE	562447	0	0
COHERENT INC COM	COM	192479103	17725	160352	SH	SOLE	156184	0	4168
COHERUS BIOSCIENCES INC COM	COM	19249H103	7905	295198	SH	SOLE	295198	0	0
COHERUS BIOSCIENCES INC COM	COM	19249H103	1835	68536	SH	OTR	68536	0	0
COLGATE PALMOLIVE CO COM	COM	194162103	77408	1044076	SH	SOLE	1021588	0	22488
COLGATE PALMOLIVE CO COM	COM	194162103	71	961	SH	OTR	0	0	961
COMCAST CORP NEW CL A	COM	20030N101	45176	680978	SH	SOLE	680978	0	0
COMERICA INC COM	COM	200340107	25130	531071	SH	SOLE	531071	0	0
COMMUNICATIONS SALESLEAS IN COM	COM	20341J104	48181	1533934	SH	SOLE	1533934	0	0
CONCHO RES INC COM	COM	20605P101	45972	334710	SH	SOLE	334710	0	0
CONMED CORP COM	COM	207410101	18092	451630	SH	SOLE	451630	0	0
CONNECTICUT WTR SVC INC COM	COM	207797101	4157	83600	SH	SOLE	83600	0	0
CONOCOPHILLIPS COM	COM	20825C104	72260	1662300	SH	SOLE	1662300	0	0
CONSOLIDATED EDISON INC COM	COM	209115104	9036	120000	SH	SOLE	120000	0	0
CONSTELLATION BRANDS INC CL A	COM	21036P108	18929	113695	SH	SOLE	113695	0	0
CONTINENTAL RESOURCES INC COM	COM	212015101	7555	145400	SH	SOLE	145400	0	0
CONTROL4 CORP COM	COM	21240D107	5587	454965	SH	SOLE	454965	0	0
CONTROL4 CORP COM	COM	21240D107	1297	105629	SH	OTR	105629	0	0
COOPER COS INC COM NEW	COM	216648402	57825	322578	SH	SOLE	302203	0	20375
CORCEPT THERAPEUTICS INC COM	COM	218352102	1073	165148	SH	SOLE	165148	0	0
CORCEPT THERAPEUTICS INC COM	COM	218352102	249	38342	SH	OTR	38342	0	0
CORESITE RLTY CORP COM	COM	21870Q105	25972	350790	SH	SOLE	347369	0	3421
CORNERSTONE ONDEMAND INC NOTE 1.500% 7/0	CV	21925YAB9	7765	7099000	PRN	SOLE	7099000	0	0
CORNING INC COM	COM	219350105	25608	1082800	SH	SOLE	1082800	0	0
COSTCO WHSL CORP NEW COM	COM	22160K105	33308	218400	SH	SOLE	218400	0	0
COSTAR GROUP INC COM	COM	22160N109	5439	25119	SH	SOLE	25119	0	0
COTT CORP QUE COM	COM	22163N106	13649	957844	SH	SOLE	957844	0	0
COTIVITI HLDGS INC COM	COM	22164K101	29627	883583	SH	SOLE	861185	0	22398
CRACKER BARREL OLD CTRY STOR COM	COM	22410J106	12865	97300	SH	SOLE	97300	0	0
CRANE CO COM	COM	224399105	11651	184900	SH	SOLE	184900	0	0
CROWN CASTLE INTL CORP NEW CNV PFD STK SR A	CVPFD	22822V200	8086	71548	SH	SOLE	71548	0	0
CULLEN FROST BANKERS INC COM	COM	229899109	23514	326862	SH	SOLE	326862	0	0
CUMMINS INC COM	COM	231021106	75057	585700	SH	SOLE	585700	0	0
CYNOSURE INC CL A	COM	232577205	3079	60446	SH	SOLE	60446	0	0
CYNOSURE INC CL A	COM	232577205	715	14027	SH	OTR	14027	0	0
CYPRESS SEMICONDUCTOR CORP COM	COM	232806109	47345	3893521	SH	SOLE	3683239	0	210282
CYRUSONE INC COM	COM	23283R100	17625	370506	SH	SOLE	366230	0	4276
D R HORTON INC COM	COM	23331A109	9890	327498	SH	SOLE	327498	0	0
DAVE  BUSTERS ENTMT INC COM	COM	238337109	64551	1647553	SH	SOLE	1630540	0	17013
DECKERS OUTDOOR CORP COM	COM	243537107	10130	170113	SH	SOLE	170113	0	0
DELTA AIR LINES INC DEL COM NEW	COM	247361702	26190	665391	SH	SOLE	653424	0	11967
DENNYS CORP COM	COM	24869P104	18815	1760076	SH	SOLE	1760076	0	0
DENTSPLY SIRONA INC COM	COM	24906P109	7119	119791	SH	SOLE	119791	0	0
DEVON ENERGY CORP NEW COM	COM	25179M103	77885	1765697	SH	SOLE	1715429	0	50268
DEVON ENERGY CORP NEW COM	COM	25179M103	69	1575	SH	OTR	0	0	1575
DEXCOM INC COM	COM	252131107	44837	511493	SH	SOLE	511493	0	0
DIAMONDBACK ENERGY INC COM	COM	25278X109	10675	110574	SH	SOLE	110574	0	0
DICKS SPORTING GOODS INC COM	COM	253393102	5264	92800	SH	SOLE	92800	0	0
DIGITAL RLTY TR INC COM	COM	253868103	10268	105726	SH	SOLE	105726	0	0
DIGITALGLOBE INC COM NEW	COM	25389M877	37234	1353957	SH	SOLE	1319665	0	34292
DISCOVER FINL SVCS COM	COM	254709108	165514	2926862	SH	SOLE	2887100	0	39762
DISCOVER FINL SVCS COM	COM	254709108	101	1779	SH	OTR	0	0	1779
DOLLAR GEN CORP NEW COM	COM	256677105	12369	176728	SH	SOLE	176728	0	0
DOLLAR TREE INC COM	COM	256746108	12442	157638	SH	SOLE	157638	0	0
DOMINION RES INC VA NEW COM	COM	25746U109	58064	781800	SH	SOLE	781800	0	0
DOMINION RES INC VA NEW UNIT 99/99/9999	CVPFD	25746U869	3483	70000	SH	SOLE	70000	0	0
DOMINOS PIZZA INC COM	COM	25754A201	23230	152981	SH	SOLE	152981	0	0
DONALDSON INC COM	COM	257651109	1531	41000	SH	SOLE	41000	0	0
DOVER CORP COM	COM	260003108	89923	1221118	SH	SOLE	1194366	0	26752
DOVER CORP COM	COM	260003108	77	1044	SH	OTR	0	0	1044
DOW CHEM CO COM	COM	260543103	94948	1831919	SH	SOLE	1775941	0	55978
DOW CHEM CO COM	COM	260543103	122	2346	SH	OTR	0	0	2346
DR PEPPER SNAPPLE GROUP INC COM	COM	26138E109	7274	79658	SH	SOLE	79658	0	0
DU PONT E I DE NEMOURS  CO COM	COM	263534109	43376	647700	SH	SOLE	647700	0	0
DUKE REALTY CORP COM NEW	COM	264411505	38271	1400317	SH	SOLE	1400317	0	0
DUKE ENERGY CORP NEW COM NEW	COM	26441C204	147876	1847525	SH	SOLE	1808513	0	39012
DUKE ENERGY CORP NEW COM NEW	COM	26441C204	92	1149	SH	OTR	0	0	1149
DULUTH HLDGS INC COM CL B	COM	26443V101	4351	164128	SH	SOLE	164128	0	0
DULUTH HLDGS INC COM CL B	COM	26443V101	1010	38106	SH	OTR	38106	0	0
DUNKIN BRANDS GROUP INC COM	COM	265504100	22321	428600	SH	SOLE	428600	0	0
DUPONT FABROS TECHNOLOGY INC COM	COM	26613Q106	10295	249570	SH	SOLE	249570	0	0
DYCOM INDS INC COM	COM	267475101	43554	532578	SH	SOLE	518722	0	13856
E L F BEAUTY INC COM	COM	26856L103	16057	571031	SH	SOLE	566010	0	5021
E L F BEAUTY INC COM	COM	26856L103	864	30731	SH	OTR	30731	0	0
EL POLLO LOCO HLDGS INC COM	COM	268603107	15887	1261882	SH	SOLE	1261882	0	0
EOG RES INC COM	COM	26875P101	161581	1670782	SH	SOLE	1624478	0	46304
EOG RES INC COM	COM	26875P101	157	1627	SH	OTR	0	0	1627
EQT CORP COM	COM	26884L109	47713	657029	SH	SOLE	615379	0	41650
E TRADE FINANCIAL CORP COM NEW	COM	269246401	49720	1707406	SH	SOLE	1707406	0	0
EAGLE MATERIALS INC COM	COM	26969P108	1987	25700	SH	SOLE	25700	0	0
EAST WEST BANCORP INC COM	COM	27579R104	201069	5477219	SH	SOLE	5291278	0	185941
EAST WEST BANCORP INC COM	COM	27579R104	135	3666	SH	OTR	0	0	3666
EASTMAN CHEM CO COM	COM	277432100	56326	832244	SH	SOLE	832244	0	0
EATON VANCE CORP COM NON VTG	COM	278265103	10493	268700	SH	SOLE	268700	0	0
ECHO GLOBAL LOGISTICS INC COM	COM	27875T101	4250	184284	SH	SOLE	184284	0	0
ECHO GLOBAL LOGISTICS INC COM	COM	27875T101	981	42560	SH	OTR	42560	0	0
ECHO GLOBAL LOGISTICS INC NOTE 2.500% 5/0	CV	27875TAA9	4344	4591000	PRN	SOLE	4591000	0	0
EDISON INTL COM	COM	281020107	169180	2341591	SH	SOLE	2341591	0	0
EDWARDS LIFESCIENCES CORP COM	COM	28176E108	69191	573917	SH	SOLE	573917	0	0
8X8 INC NEW COM	COM	282914100	6790	440034	SH	SOLE	436985	0	3049
8X8 INC NEW COM	COM	282914100	1116	72310	SH	OTR	72310	0	0
ELECTRONIC ARTS INC COM	COM	285512109	17256	202061	SH	SOLE	202061	0	0
ELECTRONICS FOR IMAGING INC COM	COM	286082102	30792	629444	SH	SOLE	629444	0	0
ELLIE MAE INC COM	COM	28849P100	104271	990228	SH	SOLE	975304	0	14924
EMCOR GROUP INC COM	COM	29084Q100	22658	380045	SH	SOLE	380045	0	0
EMERSON ELEC CO COM	COM	291011104	77104	1414499	SH	SOLE	1414499	0	0
ENDOLOGIX INC COM	COM	29266S106	3972	310325	SH	SOLE	310325	0	0
ENDOLOGIX INC COM	COM	29266S106	914	71412	SH	OTR	71412	0	0
ENDOLOGIX INC NOTE 2.250%12/1	CV	29266SAA4	10415	10800000	PRN	SOLE	10800000	0	0
EPAM SYS INC COM	COM	29414B104	8878	128092	SH	SOLE	124761	0	3331
EQUIFAX INC COM	COM	294429105	10197	75770	SH	SOLE	75770	0	0
EQUINIX INC COM PAR $0.001	COM	29444U700	21509	59705	SH	SOLE	59705	0	0
ETHAN ALLEN INTERIORS INC COM	COM	297602104	14229	455033	SH	SOLE	455033	0	0
ETSY INC COM	COM	29786A106	50371	3527387	SH	SOLE	3451636	0	75751
ETSY INC COM	COM	29786A106	824	57674	SH	OTR	57674	0	0
EURONET WORLDWIDE INC NOTE 1.500%10/0	CV	298736AH2	12723	10068000	PRN	SOLE	10068000	0	0
EVERBRIDGE INC COM	COM	29978A104	6164	365618	SH	SOLE	365618	0	0
EVERBRIDGE INC COM	COM	29978A104	1421	84300	SH	OTR	84300	0	0
EVERSOURCE ENERGY COM	COM	30040W108	34675	640000	SH	SOLE	640000	0	0
EVOLENT HEALTH INC CL A	COM	30050B101	2383	96781	SH	SOLE	96781	0	0
EVOLENT HEALTH INC CL A	COM	30050B101	553	22469	SH	OTR	22469	0	0
EXACT SCIENCES CORP COM	COM	30063P105	42540	2290814	SH	SOLE	2231278	0	59536
EXELON CORP UNIT 99/99/9999	CVPFD	30161N127	3980	85145	SH	SOLE	85145	0	0
EXELIXIS INC COM	COM	30161Q104	76374	5971377	SH	SOLE	5921064	0	50313
EXPEDIA INC DEL COM NEW	COM	30212P303	9723	83304	SH	SOLE	83304	0	0
EXXON MOBIL CORP COM	COM	30231G102	267689	3067016	SH	SOLE	2992029	0	74987
EXXON MOBIL CORP COM	COM	30231G102	240	2745	SH	OTR	0	0	2745
F M C CORP COM NEW	COM	302491303	31379	649129	SH	SOLE	649129	0	0
FCB FINL HLDGS INC CL A	COM	30255G103	6101	158745	SH	SOLE	158745	0	0
FB FINL CORP COM	COM	30257X104	2523	125000	SH	SOLE	125000	0	0
FACEBOOK INC CL A	COM	30303M102	131213	1022945	SH	SOLE	1022945	0	0
FACTSET RESH SYS INC COM	COM	303075105	8753	54000	SH	SOLE	54000	0	0
FAIR ISAAC CORP COM	COM	303250104	41038	329381	SH	SOLE	320490	0	8891
FARMER BROS CO COM	COM	307675108	2373	66746	SH	SOLE	66746	0	0
FEDERAL REALTY INVT TR SH BEN INT NEW	COM	313747206	89297	580114	SH	SOLE	532910	0	47204
FEDEX CORP COM	COM	31428X106	74599	427061	SH	SOLE	427061	0	0
FERRO CORP COM	COM	315405100	4081	295530	SH	SOLE	295530	0	0
FERRO CORP COM	COM	315405100	938	67927	SH	OTR	67927	0	0
FIDELITY NATL INFORMATION SV COM	COM	31620M106	253874	3295775	SH	SOLE	3188688	0	107087
FIDELITY NATL INFORMATION SV COM	COM	31620M106	82	1059	SH	OTR	0	0	1059
FIFTH THIRD BANCORP COM	COM	316773100	114164	5579870	SH	SOLE	5579870	0	0
FINISAR CORP NOTE 0.500%12/1	CV	31787AAM3	5963	5040000	PRN	SOLE	5040000	0	0
FIREEYE INC COM	COM	31816Q101	43677	2965179	SH	SOLE	2802752	0	162427
FIRST INDUSTRIAL REALTY TRUS COM	COM	32054K103	32848	1163982	SH	SOLE	1163982	0	0
FIRST MERCHANTS CORP COM	COM	320817109	38164	1426706	SH	SOLE	1426706	0	0
FLAGSTAR BANCORP INC COM PAR .001	COM	337930705	10958	394900	SH	SOLE	394900	0	0
FIRSTENERGY CORP COM	COM	337932107	10652	322000	SH	SOLE	322000	0	0
FIVE BELOW INC COM	COM	33829M101	34464	855408	SH	SOLE	832349	0	23059
FIVE9 INC COM	COM	338307101	33346	2126644	SH	SOLE	2090887	0	35757
FIVE9 INC COM	COM	338307101	2795	178241	SH	OTR	178241	0	0
FIVE PRIME THERAPEUTICS INC COM	COM	33830X104	4818	91794	SH	SOLE	91794	0	0
FIVE PRIME THERAPEUTICS INC COM	COM	33830X104	1116	21268	SH	OTR	21268	0	0
FLEETCOR TECHNOLOGIES INC COM	COM	339041105	12461	71724	SH	SOLE	71724	0	0
FLOTEK INDS INC DEL COM	COM	343389102	1861	128000	SH	SOLE	128000	0	0
FLUIDIGM CORP DEL COM	COM	34385P108	1871	233634	SH	SOLE	233634	0	0
FLUIDIGM CORP DEL COM	COM	34385P108	435	54333	SH	OTR	54333	0	0
FOOT LOCKER INC COM	COM	344849104	37093	547736	SH	SOLE	531300	0	16436
FORD MTR CO DEL COM PAR $0.01	COM	345370860	101406	8401500	SH	SOLE	8401500	0	0
FORTINET INC COM	COM	34959E109	6986	189165	SH	SOLE	189165	0	0
FORTUNE BRANDS HOME  SEC IN COM	COM	34964C106	14063	242046	SH	SOLE	242046	0	0
FOUNDATION MEDICINE INC COM	COM	350465100	4469	191382	SH	SOLE	191382	0	0
FOUNDATION MEDICINE INC COM	COM	350465100	1028	44039	SH	OTR	44039	0	0
FOX FACTORY HLDG CORP COM	COM	35138V102	7572	329665	SH	SOLE	329665	0	0
FOX FACTORY HLDG CORP COM	COM	35138V102	1751	76240	SH	OTR	76240	0	0
FRANKLIN ELEC INC COM	COM	353514102	1669	41000	SH	SOLE	41000	0	0
FRONTIER COMMUNICATIONS CORP COM	COM	35906A108	7758	1864900	SH	SOLE	1864900	0	0
FRONTIER COMMUNICATIONS CORP PFD CONV SER-A	CVPFD	35906A207	6901	82245	SH	SOLE	82245	0	0
GW PHARMACEUTICALS PLC ADS	ADR	36197T103	19081	143758	SH	SOLE	140135	0	3623
GMS INC COM	COM	36251C103	6349	285601	SH	SOLE	285601	0	0
GENERAL DYNAMICS CORP COM	COM	369550108	160429	1033961	SH	SOLE	1006826	0	27135
GENERAL DYNAMICS CORP COM	COM	369550108	137	885	SH	OTR	0	0	885
GENERAL ELECTRIC CO COM	COM	369604103	260705	8801658	SH	SOLE	8607078	0	194580
GENERAL ELECTRIC CO COM	COM	369604103	213	7199	SH	OTR	0	0	7199
GENERAL GROWTH PPTYS INC NEW COM	COM	370023103	78354	2838900	SH	SOLE	2838900	0	0
GENERAL MLS INC COM	COM	370334104	14993	234700	SH	SOLE	234700	0	0
GENERAL MTRS CO COM	COM	37045V100	49901	1570700	SH	SOLE	1570700	0	0
GENESEE  WYO INC CL A	COM	371559105	46810	678902	SH	SOLE	630446	0	48456
GENOMIC HEALTH INC COM	COM	37244C101	4289	148314	SH	SOLE	148314	0	0
GENOMIC HEALTH INC COM	COM	37244C101	990	34248	SH	OTR	34248	0	0
GENUINE PARTS CO COM	COM	372460105	15781	157100	SH	SOLE	157100	0	0
GIBRALTAR INDS INC COM	COM	374689107	37398	1006671	SH	SOLE	1006671	0	0
GIGAMON INC COM	COM	37518B102	39214	715579	SH	SOLE	698329	0	17250
GIGAMON INC COM	COM	37518B102	600	10952	SH	OTR	10952	0	0
GILEAD SCIENCES INC COM	COM	375558103	12383	156505	SH	SOLE	156505	0	0
GLAUKOS CORP COM	COM	377322102	66657	1766209	SH	SOLE	1737116	0	29093
GLAUKOS CORP COM	COM	377322102	1744	46210	SH	OTR	46210	0	0
GODADDY INC CL A	COM	380237107	42812	1239840	SH	SOLE	1222516	0	17324
GOODYEAR TIRE  RUBR CO COM	COM	382550101	7713	238800	SH	SOLE	238800	0	0
GRACO INC COM	COM	384109104	17338	234300	SH	SOLE	234300	0	0
GRANITE CONSTR INC COM	COM	387328107	20286	407838	SH	SOLE	407838	0	0
GRAPHIC PACKAGING HLDG CO COM	COM	388689101	30661	2191626	SH	SOLE	2191626	0	0
GREAT PLAINS ENERGY INC COM	COM	391164100	36387	1333353	SH	SOLE	1333353	0	0
GREEN PLAINS INC NOTE 3.250%10/0	CV	393222AD6	2540	1827000	PRN	SOLE	1827000	0	0
GRUBHUB INC COM	COM	400110102	109977	2558201	SH	SOLE	2518045	0	40156
GRUPO FINANCIERO SANTANDER M SPON ADR SHS B	ADR	40053C105	138	15678	SH	SOLE	7934	0	7744
GRUPO FINANCIERO SANTANDER M SPON ADR SHS B	ADR	40053C105	6	675	SH	OTR	0	0	675
HCP INC COM	COM	40414L109	5359	141200	SH	SOLE	141200	0	0
HD SUPPLY HLDGS INC COM	COM	40416M105	4735	148070	SH	SOLE	148070	0	0
HAIN CELESTIAL GROUP INC COM	COM	405217100	3899	109579	SH	SOLE	109579	0	0
HALLIBURTON CO COM	COM	406216101	109091	2430717	SH	SOLE	2357000	0	73717
HALLIBURTON CO COM	COM	406216101	124	2760	SH	OTR	0	0	2760
HANESBRANDS INC COM	COM	410345102	6171	244402	SH	SOLE	244402	0	0
HANNON ARMSTRONG SUST INFR C COM	COM	41068X100	4251	181894	SH	SOLE	181894	0	0
HANNON ARMSTRONG SUST INFR C COM	COM	41068X100	978	41857	SH	OTR	41857	0	0
HANOVER INS GROUP INC COM	COM	410867105	35559	471481	SH	SOLE	471481	0	0
HARRIS CORP DEL COM	COM	413875105	31516	344023	SH	SOLE	344023	0	0
HARTFORD FINL SVCS GROUP INC COM	COM	416515104	186738	4360994	SH	SOLE	4205668	0	155326
HARTFORD FINL SVCS GROUP INC COM	COM	416515104	78	1818	SH	OTR	0	0	1818
HASBRO INC COM	COM	418056107	6084	76691	SH	SOLE	76691	0	0
HAWAIIAN HOLDINGS INC COM	COM	419879101	3524	72519	SH	SOLE	72519	0	0
HEALTHSOUTH CORP COM NEW	COM	421924309	139940	3449336	SH	SOLE	3296461	0	152875
HEALTHWAYS INC COM	COM	422245100	4985	188391	SH	SOLE	188391	0	0
HEALTHWAYS INC COM	COM	422245100	1155	43649	SH	OTR	43649	0	0
HEALTHCARE TR AMER INC CL A NEW	COM	42225P501	60788	1863524	SH	SOLE	1863524	0	0
HEALTHEQUITY INC COM	COM	42226A107	5379	142108	SH	SOLE	138511	0	3597
HEICO CORP NEW COM	COM	422806109	8807	127268	SH	SOLE	124039	0	3229
HELMERICH  PAYNE INC COM	COM	423452101	34605	514184	SH	SOLE	487252	0	26932
HEMISPHERE MEDIA GROUP INC CL A	COM	42365Q103	1586	124379	SH	SOLE	124379	0	0
HENRY JACK  ASSOC INC COM	COM	426281101	8684	101512	SH	SOLE	101512	0	0
HERBALIFE LTD NOTE 2.000% 8/1	CV	42703MAB9	10208	10298000	PRN	SOLE	10298000	0	0
HESS CORP COM	COM	42809H107	9485	176900	SH	SOLE	176900	0	0
HEWLETT PACKARD ENTERPRISE C COM	COM	42824C109	80565	3541312	SH	SOLE	3429714	0	111598
HEWLETT PACKARD ENTERPRISE C COM	COM	42824C109	92	4032	SH	OTR	0	0	4032
HEXCEL CORP NEW COM	COM	428291108	9529	215100	SH	SOLE	215100	0	0
HIGHWOODS PPTYS INC COM	COM	431284108	99566	1910316	SH	SOLE	1812376	0	97940
HOLOGIC INC DEBT 2.000% 3/0	CV	436440AC5	9188	6731000	PRN	SOLE	6731000	0	0
HOME DEPOT INC COM	COM	437076102	64091	498066	SH	SOLE	498066	0	0
HOMESTREET INC COM	COM	43785V102	4754	189688	SH	SOLE	189688	0	0
HOMESTREET INC COM	COM	43785V102	1101	43950	SH	OTR	43950	0	0
HONEYWELL INTL INC COM	COM	438516106	1201	10304	SH	SOLE	10304	0	0
HORMEL FOODS CORP COM	COM	440452100	10579	278900	SH	SOLE	278900	0	0
HOST HOTELS  RESORTS INC COM	COM	44107P104	4110	264000	SH	SOLE	264000	0	0
HUBBELL INC COM	COM	443510607	95573	887070	SH	SOLE	851461	0	35609
HUBSPOT INC COM	COM	443573100	38494	668062	SH	SOLE	650605	0	17457
HUNT J B TRANS SVCS INC COM	COM	445658107	5626	69336	SH	SOLE	69336	0	0
HUNTINGTON INGALLS INDS INC COM	COM	446413106	17022	110953	SH	SOLE	110953	0	0
HUNTSMAN CORP COM	COM	447011107	47458	2916895	SH	SOLE	2916895	0	0
ICF INTL INC COM	COM	44925C103	18236	411453	SH	SOLE	411453	0	0
ITT INC COM	COM	45073V108	70696	1972537	SH	SOLE	1937204	0	35333
ITT INC COM	COM	45073V108	70	1967	SH	OTR	0	0	1967
ICICI BK LTD ADR	ADR	45104G104	148	19872	SH	SOLE	9991	0	9881
ICICI BK LTD ADR	ADR	45104G104	6	776	SH	OTR	0	0	776
IDACORP INC COM	COM	451107106	41377	528575	SH	SOLE	528575	0	0
IDEX CORP COM	COM	45167R104	8483	90664	SH	SOLE	90664	0	0
IDEXX LABS INC COM	COM	45168D104	33724	299160	SH	SOLE	299160	0	0
ILLINOIS TOOL WKS INC COM	COM	452308109	24314	202890	SH	SOLE	202890	0	0
ILLUMINA INC COM	COM	452327109	11271	62047	SH	SOLE	62047	0	0
ILLUMINA INC NOTE 0.500% 6/1	CV	452327AH2	8277	7550000	PRN	SOLE	7550000	0	0
IMAX CORP COM	COM	45245E109	25841	892001	SH	SOLE	869036	0	22965
INCYTE CORP COM	COM	45337C102	25751	273106	SH	SOLE	273106	0	0
INCYTE CORP NOTE 0.375%11/1	CV	45337CAM4	13485	7088000	PRN	SOLE	7088000	0	0
INGEVITY CORP COM	COM	45688C107	7218	156569	SH	SOLE	146314	0	10255
INPHI CORP COM	COM	45772F107	46587	1070720	SH	SOLE	1045502	0	25218
INPHI CORP COM	COM	45772F107	909	20894	SH	OTR	20894	0	0
INSPERITY INC COM	COM	45778Q107	17958	247222	SH	SOLE	241664	0	5558
INSPERITY INC COM	COM	45778Q107	504	6933	SH	OTR	6933	0	0
INOGEN INC COM	COM	45780L104	6793	113412	SH	SOLE	113412	0	0
INOGEN INC COM	COM	45780L104	1561	26064	SH	OTR	26064	0	0
INSTRUCTURE INC COM	COM	45781U103	30675	1209095	SH	SOLE	1190369	0	18726
INSTRUCTURE INC COM	COM	45781U103	2821	111211	SH	OTR	111211	0	0
INSULET CORP COM	COM	45784P101	33439	816781	SH	SOLE	796088	0	20693
INTEGRA LIFESCIENCES HLDGS C COM NEW	COM	457985208	35273	427289	SH	SOLE	421689	0	5600
INTEL CORP COM	COM	458140100	338071	8955514	SH	SOLE	8808315	0	147199
INTEL CORP COM	COM	458140100	171	4536	SH	OTR	0	0	4536
INTEL CORP SDCV 3.250% 8/0	CV	458140AF7	44785	24464000	PRN	SOLE	24464000	0	0
INTERCONTINENTAL EXCHANGE IN COM	COM	45866F104	29350	108961	SH	SOLE	108961	0	0
INTERNATIONAL BUSINESS MACHS COM	COM	459200101	155337	977887	SH	SOLE	977887	0	0
INTERNATIONAL FLAVORSFRAGRA COM	COM	459506101	28917	202257	SH	SOLE	202257	0	0
INTL PAPER CO COM	COM	460146103	68776	1433439	SH	SOLE	1433439	0	0
INTUITIVE SURGICAL INC COM NEW	COM	46120E602	82236	113455	SH	SOLE	113455	0	0
IROBOT CORP COM	COM	462726100	33313	757463	SH	SOLE	740664	0	16799
IROBOT CORP COM	COM	462726100	1083	24626	SH	OTR	24626	0	0
ISHARES TR EAFE SML CP ETF	ETF	464288273	6215	118576	SH	SOLE	118576	0	0
ITC HLDGS CORP COM	COM	465685105	52776	1135450	SH	SOLE	1045562	0	89888
JPMORGAN CHASE  CO COM	COM	46625H100	419636	6301784	SH	SOLE	6204902	0	96882
JPMORGAN CHASE  CO COM	COM	46625H100	221	3321	SH	OTR	0	0	3321
JABIL CIRCUIT INC COM	COM	466313103	5407	247800	SH	SOLE	247800	0	0
JACOBS ENGR GROUP INC DEL COM	COM	469814107	56039	1083507	SH	SOLE	1002645	0	80862
JEFFERIES GROUP INC NEW DBCV 3.875%11/0	CV	472319AG7	4171	4099000	PRN	SOLE	4099000	0	0
JETBLUE AIRWAYS CORP COM	COM	477143101	8341	483800	SH	SOLE	483800	0	0
JOHNSON  JOHNSON COM	COM	478160104	352776	2986341	SH	SOLE	2937071	0	49270
JOHNSON  JOHNSON COM	COM	478160104	202	1710	SH	OTR	0	0	1710
JONES ENERGY INC COM CL A	COM	48019R108	1235	347000	SH	SOLE	347000	0	0
JUNIPER NETWORKS INC COM	COM	48203R104	83614	3475218	SH	SOLE	3475218	0	0
KAR AUCTION SVCS INC COM	COM	48238T109	113103	2620547	SH	SOLE	2486632	0	133915
KLA-TENCOR CORP COM	COM	482480100	16612	238300	SH	SOLE	238300	0	0
KANSAS CITY SOUTHERN COM NEW	COM	485170302	31988	342775	SH	SOLE	342775	0	0
KB HOME NOTE 1.375% 2/0	CV	48666KAS8	18959	19395000	PRN	SOLE	19395000	0	0
KELLOGG CO COM	COM	487836108	39556	510597	SH	SOLE	510597	0	0
KENNAMETAL INC COM	COM	489170100	32138	1107445	SH	SOLE	1107445	0	0
KEYCORP NEW COM	COM	493267108	1314	108000	SH	SOLE	108000	0	0
KEYCORP NEW PFD 7.75% SR A	CVPFD	493267405	3263	23899	SH	SOLE	23899	0	0
KIMBERLY CLARK CORP COM	COM	494368103	139542	1106250	SH	SOLE	1106250	0	0
KIMCO RLTY CORP COM	COM	49446R109	49287	1702502	SH	SOLE	1702502	0	0
KINDER MORGAN INC DEL COM	COM	49456B101	58850	2544300	SH	SOLE	2544300	0	0
KINDER MORGAN INC DEL PFD SER A	CVPFD	49456B200	8242	164605	SH	SOLE	164605	0	0
KOHLS CORP COM	COM	500255104	5858	133900	SH	SOLE	133900	0	0
KRAFT HEINZ CO COM	COM	500754106	53464	597301	SH	SOLE	597301	0	0
L BRANDS INC COM	COM	501797104	71875	1015620	SH	SOLE	987245	0	28375
L BRANDS INC COM	COM	501797104	68	957	SH	OTR	0	0	957
LGI HOMES INC COM	COM	50187T106	21262	577142	SH	SOLE	577142	0	0
LGI HOMES INC COM	COM	50187T106	2054	55765	SH	OTR	55765	0	0
LGI HOMES INC NOTE 4.250%11/1	CV	50187TAB2	8715	4950000	PRN	SOLE	4950000	0	0
LKQ CORP COM	COM	501889208	8885	250555	SH	SOLE	250555	0	0
LSI INDS INC COM	COM	50216C108	4056	361217	SH	SOLE	361217	0	0
LSI INDS INC COM	COM	50216C108	933	83123	SH	OTR	83123	0	0
LAM RESEARCH CORP COM	COM	512807108	62841	663506	SH	SOLE	635163	0	28343
LAM RESEARCH CORP NOTE 1.250% 5/1	CV	512807AL2	5014	3140000	PRN	SOLE	3140000	0	0
LAWSON PRODS INC COM	COM	520776105	2113	119200	SH	SOLE	119200	0	0
LEAR CORP COM NEW	COM	521865204	9176	75700	SH	SOLE	75700	0	0
LEIDOS HLDGS INC COM	COM	525327102	7609	175800	SH	SOLE	175800	0	0
LENDINGTREE INC NEW COM	COM	52603B107	30824	318071	SH	SOLE	311328	0	6743
LENDINGTREE INC NEW COM	COM	52603B107	1266	13068	SH	OTR	13068	0	0
LENNAR CORP CL A	COM	526057104	118557	2800121	SH	SOLE	2691554	0	108567
LENNAR CORP CL A	COM	526057104	46	1078	SH	OTR	0	0	1078
LENNOX INTL INC COM	COM	526107107	4757	30296	SH	SOLE	30296	0	0
LINCOLN NATL CORP IND COM	COM	534187109	56681	1206500	SH	SOLE	1206500	0	0
LITTELFUSE INC COM	COM	537008104	41873	325073	SH	SOLE	325073	0	0
LIVE NATION ENTERTAINMENT IN COM	COM	538034109	35916	1306992	SH	SOLE	1274032	0	32960
LIVE NATION ENTERTAINMENT IN DBCV 2.500% 5/1	CV	538034AJ8	13602	12500000	PRN	SOLE	12500000	0	0
LLOYDS BANKING GROUP PLC SPONSORED ADR	ADR	539439109	84	29319	SH	SOLE	14601	0	14718
LLOYDS BANKING GROUP PLC SPONSORED ADR	ADR	539439109	4	1236	SH	OTR	0	0	1236
LLOYDS BANKING GROUP PLC SDCV 7.500%12/3	CV	539439AG4	10473	10117000	PRN	SOLE	10117000	0	0
LOCKHEED MARTIN CORP COM	COM	539830109	110280	460036	SH	SOLE	460036	0	0
LOUISIANA PAC CORP COM	COM	546347105	16201	860368	SH	SOLE	860368	0	0
LOWES COS INC COM	COM	548661107	37361	517400	SH	SOLE	517400	0	0
LYDALL INC DEL COM	COM	550819106	2276	44507	SH	SOLE	44507	0	0
M  T BK CORP COM	COM	55261F104	71107	612467	SH	SOLE	612467	0	0
MB FINANCIAL INC NEW COM	COM	55264U108	24038	631916	SH	SOLE	631916	0	0
MGIC INVT CORP WIS NOTE 2.000% 4/0	CV	552848AE3	12006	9477000	PRN	SOLE	9477000	0	0
MGM RESORTS INTERNATIONAL COM	COM	552953101	36985	1420853	SH	SOLE	1420853	0	0
MGP INGREDIENTS INC NEW COM	COM	55303J106	3347	82594	SH	SOLE	82594	0	0
MGP INGREDIENTS INC NEW COM	COM	55303J106	764	18856	SH	OTR	18856	0	0
M/I HOMES INC COM	COM	55305B101	1650	70000	SH	SOLE	70000	0	0
MKS INSTRUMENT INC COM	COM	55306N104	5371	108000	SH	SOLE	108000	0	0
MRC GLOBAL INC COM	COM	55345K103	11613	706840	SH	SOLE	706840	0	0
MSC INDL DIRECT INC CL A	COM	553530106	50608	689391	SH	SOLE	658198	0	31193
MSCI INC COM	COM	55354G100	38958	464114	SH	SOLE	464114	0	0
MACOM TECH SOLUTIONS HLDGS I COM	COM	55405Y100	51812	1223715	SH	SOLE	1149455	0	74260
MADDEN STEVEN LTD COM	COM	556269108	73781	2134876	SH	SOLE	2002843	0	132033
MARATHON OIL CORP COM	COM	565849106	41834	2646027	SH	SOLE	2620527	0	25500
MARCUS  MILLICHAP INC COM	COM	566324109	12282	469663	SH	SOLE	469663	0	0
MARKEL CORP COM	COM	570535104	40297	43387	SH	SOLE	40125	0	3262
MARKETAXESS HLDGS INC COM	COM	57060D108	90358	545673	SH	SOLE	539482	0	6191
MARSH  MCLENNAN COS INC COM	COM	571748102	69967	1040400	SH	SOLE	1040400	0	0
MARRIOTT INTL INC NEW CL A	COM	571903202	15589	231537	SH	SOLE	231537	0	0
MARTIN MARIETTA MATLS INC COM	COM	573284106	10581	59073	SH	SOLE	59073	0	0
MASCO CORP COM	COM	574599106	4007	116800	SH	SOLE	116800	0	0
MASIMO CORP COM	COM	574795100	18581	312334	SH	SOLE	304321	0	8013
MASTERCARD INCORPORATED CL A	COM	57636Q104	12167	119554	SH	SOLE	119554	0	0
MATCH GROUP INC COM	COM	57665R106	29459	1655908	SH	SOLE	1613190	0	42718
MATERIALISE NV SPONSORED ADS	ADR	57667T100	10438	1355523	SH	SOLE	1327376	0	28147
MATERIALISE NV SPONSORED ADS	ADR	57667T100	702	91137	SH	OTR	91137	0	0
MATTEL INC COM	COM	577081102	34280	1132100	SH	SOLE	1132100	0	0
MAXLINEAR INC CL A	COM	57776J100	28122	1387392	SH	SOLE	1360880	0	26512
MAXLINEAR INC CL A	COM	57776J100	911	44937	SH	OTR	44937	0	0
MAXIMUS INC COM	COM	577933104	58091	1027068	SH	SOLE	974355	0	52713
MCCORMICK  CO INC COM NON VTG	COM	579780206	8959	89659	SH	SOLE	89659	0	0
MCDONALDS CORP COM	COM	580135101	126734	1098600	SH	SOLE	1098600	0	0
MEAD JOHNSON NUTRITION CO COM	COM	582839106	4870	61644	SH	SOLE	61644	0	0
MEDIDATA SOLUTIONS INC COM	COM	58471A105	8787	157582	SH	SOLE	153584	0	3998
MEDIDATA SOLUTIONS INC NOTE 1.000% 8/0	CV	58471AAB1	22502	19181000	PRN	SOLE	19181000	0	0
MERCADOLIBRE INC COM	COM	58733R102	34306	185470	SH	SOLE	185470	0	0
MERCADOLIBRE INC NOTE 2.250% 7/0	CV	58733RAB8	23646	15115000	PRN	SOLE	15115000	0	0
MERCK  CO INC COM	COM	58933Y105	74174	1188500	SH	SOLE	1188500	0	0
MERCURY SYS INC COM	COM	589378108	4493	182872	SH	SOLE	182872	0	0
MERCURY SYS INC COM	COM	589378108	1042	42392	SH	OTR	42392	0	0
METLIFE INC COM	COM	59156R108	69395	1561900	SH	SOLE	1561900	0	0
METTLER TOLEDO INTERNATIONAL COM	COM	592688105	10606	25262	SH	SOLE	25262	0	0
MICHAELS COS INC COM	COM	59408Q106	7754	320798	SH	SOLE	320798	0	0
MICROSOFT CORP COM	COM	594918104	200530	3481426	SH	SOLE	3451868	0	29558
MICROSOFT CORP COM	COM	594918104	67	1168	SH	OTR	0	0	1168
MICROCHIP TECHNOLOGY INC COM	COM	595017104	116928	1881681	SH	SOLE	1848196	0	33485
MICROCHIP TECHNOLOGY INC COM	COM	595017104	88	1421	SH	OTR	0	0	1421
MICROCHIP TECHNOLOGY INC SDCV 2.125%12/1	CV	595017AB0	3499	1350000	PRN	SOLE	1350000	0	0
MICROCHIP TECHNOLOGY INC NOTE 1.625% 2/1	CV	595017AD6	35648	27850000	PRN	SOLE	27850000	0	0
MICRON TECHNOLOGY INC COM	COM	595112103	14546	818100	SH	SOLE	818100	0	0
MICRON TECHNOLOGY INC NOTE 2.125% 2/1	CV	595112AV5	9378	5300000	PRN	SOLE	5300000	0	0
MICRON TECHNOLOGY INC NOTE 3.000%11/1	CV	595112AY9	13064	14617000	PRN	SOLE	14617000	0	0
MID-AMER APT CMNTYS INC COM	COM	59522J103	7294	77600	SH	SOLE	77600	0	0
MIDDLEBY CORP COM	COM	596278101	41688	337223	SH	SOLE	337223	0	0
MILACRON HLDGS CORP COM	COM	59870L106	20296	1271687	SH	SOLE	1271687	0	0
MILLER HERMAN INC COM	COM	600544100	45646	1596006	SH	SOLE	1478258	0	117748
MINERALS TECHNOLOGIES INC COM	COM	603158106	43840	620174	SH	SOLE	611641	0	8533
MOELIS  CO CL A	COM	60786M105	31279	1163230	SH	SOLE	1081516	0	81714
MOHAWK INDS INC COM	COM	608190104	6681	33350	SH	SOLE	33350	0	0
MOLSON COORS BREWING CO CL B	COM	60871R209	56377	513453	SH	SOLE	513453	0	0
MONDELEZ INTL INC CL A	COM	609207105	127387	2901756	SH	SOLE	2809863	0	91893
MONDELEZ INTL INC CL A	COM	609207105	167	3805	SH	OTR	0	0	3805
MONOLITHIC PWR SYS INC COM	COM	609839105	34937	434005	SH	SOLE	421727	0	12278
MONSANTO CO NEW COM	COM	61166W101	29489	288544	SH	SOLE	288544	0	0
MOODYS CORP COM	COM	615369105	9930	91709	SH	SOLE	91709	0	0
MORGAN STANLEY COM NEW	COM	617446448	3827	119363	SH	SOLE	107310	0	12053
MORGAN STANLEY COM NEW	COM	617446448	61	1889	SH	OTR	0	0	1889
MOTOROLA SOLUTIONS INC COM NEW	COM	620076307	64054	839723	SH	SOLE	839723	0	0
MURPHY OIL CORP COM	COM	626717102	3456	113700	SH	SOLE	113700	0	0
MURPHY USA INC COM	COM	626755102	3126	43800	SH	SOLE	43800	0	0
NV5 GLOBAL INC COM	COM	62945V109	8792	272127	SH	SOLE	272127	0	0
NV5 GLOBAL INC COM	COM	62945V109	2040	63136	SH	OTR	63136	0	0
NXP SEMICONDUCTORS N V DBCV 1.000%12/0	CV	62952QAB6	1557	1300000	PRN	SOLE	1300000	0	0
NANOSTRING TECHNOLOGIES INC COM	COM	63009R109	7493	375034	SH	SOLE	375034	0	0
NANOSTRING TECHNOLOGIES INC COM	COM	63009R109	1737	86937	SH	OTR	86937	0	0
NATERA INC COM	COM	632307104	4529	407649	SH	SOLE	407649	0	0
NATERA INC COM	COM	632307104	1051	94644	SH	OTR	94644	0	0
NATIONAL COMM CORP COM	COM	63546L102	4552	168236	SH	SOLE	168236	0	0
NATIONAL OILWELL VARCO INC COM	COM	637071101	7679	209000	SH	SOLE	209000	0	0
NATIONAL STORAGE AFFILIATES COM SHS BEN IN	COM	637870106	1830	87413	SH	SOLE	87413	0	0
NATIONAL STORAGE AFFILIATES COM SHS BEN IN	COM	637870106	421	20115	SH	OTR	20115	0	0
NAVIENT CORP COM	COM	63938C108	21462	1483200	SH	SOLE	1483200	0	0
NEENAH PAPER INC COM	COM	640079109	11078	140204	SH	SOLE	140204	0	0
NETAPP INC COM	COM	64110D104	2737	76400	SH	SOLE	76400	0	0
NETEASE INC SPONSORED ADR	ADR	64110W102	40502	168213	SH	SOLE	168213	0	0
NEUROCRINE BIOSCIENCES INC COM	COM	64125C109	17509	345748	SH	SOLE	336595	0	9153
NEVRO CORP COM	COM	64157F103	77688	744214	SH	SOLE	728451	0	15763
NEVRO CORP NOTE 1.750% 6/0	CV	64157FAA1	22012	16843000	PRN	SOLE	16843000	0	0
NEW JERSEY RES COM	COM	646025106	5219	158822	SH	SOLE	154813	0	4009
NEW ORIENTAL ED  TECH GRP I SPON ADR	ADR	647581107	16690	360004	SH	SOLE	360004	0	0
NEW YORK TIMES CO CL A	COM	650111107	47539	3978175	SH	SOLE	3685873	0	292302
NEWELL BRANDS INC COM	COM	651229106	96318	1829048	SH	SOLE	1744559	0	84489
NEWMONT MINING CORP COM	COM	651639106	39535	1006226	SH	SOLE	1006226	0	0
NEXTERA ENERGY INC COM	COM	65339F101	125388	1025078	SH	SOLE	997648	0	27430
NEXTERA ENERGY INC COM	COM	65339F101	124	1010	SH	OTR	0	0	1010
NEXTERA ENERGY INC UNIT 09/01/2019	CVPFD	65339F820	16685	335032	SH	SOLE	335032	0	0
NEXTERA ENERGY INC UNIT 08/31/2018	CVPFD	65339F846	4470	75711	SH	SOLE	75711	0	0
NIKE INC CL B	COM	654106103	24735	469800	SH	SOLE	469800	0	0
NOBLE ENERGY INC COM	COM	655044105	57285	1602818	SH	SOLE	1602818	0	0
NORDSON CORP COM	COM	655663102	78100	783902	SH	SOLE	773302	0	10600
NORDSTROM INC COM	COM	655664100	34067	656646	SH	SOLE	607536	0	49110
NORFOLK SOUTHERN CORP COM	COM	655844108	45492	468700	SH	SOLE	468700	0	0
NORTHROP GRUMMAN CORP COM	COM	666807102	36652	171311	SH	SOLE	171311	0	0
NOVELLUS SYS INC NOTE 2.625% 5/1	CV	670008AD3	15089	5407000	PRN	SOLE	5407000	0	0
NOW INC COM	COM	67011P100	6065	283000	SH	SOLE	283000	0	0
NUTANIX INC CL A	COM	67059N108	26085	705000	SH	SOLE	697106	0	7894
NVIDIA CORP COM	COM	67066G104	68761	1003524	SH	SOLE	1003524	0	0
NVIDIA CORP NOTE 1.000%12/0	CV	67066GAC8	51797	15201000	PRN	SOLE	15201000	0	0
NUVASIVE INC COM	COM	670704105	2949	44246	SH	SOLE	44246	0	0
NUVASIVE INC NOTE 2.750% 7/0	CV	670704AC9	6951	4309000	PRN	SOLE	4309000	0	0
NXSTAGE MEDICAL INC COM	COM	67072V103	2391	95660	SH	SOLE	95660	0	0
NXSTAGE MEDICAL INC COM	COM	67072V103	554	22164	SH	OTR	22164	0	0
O REILLY AUTOMOTIVE INC NEW COM	COM	67103H107	11369	40587	SH	SOLE	40587	0	0
OASIS PETE INC NEW NOTE 2.625% 9/1	CV	674215AJ7	9915	8750000	PRN	SOLE	8750000	0	0
OCCIDENTAL PETE CORP DEL COM	COM	674599105	207866	2850601	SH	SOLE	2788417	0	62184
OCCIDENTAL PETE CORP DEL COM	COM	674599105	153	2103	SH	OTR	0	0	2103
OCLARO INC COM NEW	COM	67555N206	3863	451827	SH	SOLE	451827	0	0
OCLARO INC COM NEW	COM	67555N206	896	104738	SH	OTR	104738	0	0
OLD DOMINION FGHT LINES INC COM	COM	679580100	43331	631552	SH	SOLE	585085	0	46467
OLD REP INTL CORP COM	COM	680223104	8886	504300	SH	SOLE	504300	0	0
OLLIES BARGAIN OUTLT HLDGS I COM	COM	681116109	21617	824750	SH	SOLE	803217	0	21533
OMNICOM GROUP INC COM	COM	681919106	37052	435900	SH	SOLE	435900	0	0
ON SEMICONDUCTOR CORP COM	COM	682189105	40335	3273952	SH	SOLE	3273952	0	0
ON SEMICONDUCTOR CORP NOTE 1.000%12/0	CV	682189AK1	30910	30341000	PRN	SOLE	30341000	0	0
ONE GAS INC COM	COM	68235P108	5226	84506	SH	SOLE	82369	0	2137
ONEOK INC NEW COM	COM	682680103	21255	413600	SH	SOLE	413600	0	0
ORBITAL ATK INC COM	COM	68557N103	41658	546473	SH	SOLE	546473	0	0
PBF ENERGY INC CL A	COM	69318G106	1628	71900	SH	SOLE	71900	0	0
PDC ENERGY INC NOTE 1.125% 9/1	CV	69327RAD3	15419	14444000	PRN	SOLE	14444000	0	0
PGE CORP COM	COM	69331C108	32777	535831	SH	SOLE	535831	0	0
PPG INDS INC COM	COM	693506107	30678	296812	SH	SOLE	296812	0	0
PPL CORP COM	COM	69351T106	102868	2975642	SH	SOLE	2975642	0	0
PVH CORP COM	COM	693656100	33920	306970	SH	SOLE	306970	0	0
PACIFIC BIOSCIENCES CALIF IN COM	COM	69404D108	55026	6141264	SH	SOLE	6024754	0	116510
PACIFIC BIOSCIENCES CALIF IN COM	COM	69404D108	2268	253100	SH	OTR	253100	0	0
PACIFIC PREMIER BANCORP COM	COM	69478X105	5315	200880	SH	SOLE	200880	0	0
PACIFIC PREMIER BANCORP COM	COM	69478X105	495	18723	SH	OTR	18723	0	0
PACKAGING CORP AMER COM	COM	695156109	10700	131679	SH	SOLE	131679	0	0
PALO ALTO NETWORKS INC COM	COM	697435105	9398	58986	SH	SOLE	58986	0	0
PALO ALTO NETWORKS INC NOTE 7/0	CV	697435AB1	9161	5990000	PRN	SOLE	5990000	0	0
PANERA BREAD CO CL A	COM	69840W108	25338	130124	SH	SOLE	127783	0	2341
PARSLEY ENERGY INC CL A	COM	701877102	30017	895752	SH	SOLE	895752	0	0
PATRICK INDS INC COM	COM	703343103	25479	411488	SH	SOLE	411488	0	0
PATRICK INDS INC COM	COM	703343103	2407	38876	SH	OTR	38876	0	0
PATTERSON UTI ENERGY INC COM	COM	703481101	53985	2413298	SH	SOLE	2413298	0	0
PAYCOM SOFTWARE INC COM	COM	70432V102	83112	1657930	SH	SOLE	1625376	0	32554
PAYLOCITY HLDG CORP COM	COM	70438V106	66795	1502367	SH	SOLE	1472274	0	30093
PAYPAL HLDGS INC COM	COM	70450Y103	17478	426607	SH	SOLE	426607	0	0
PENSKE AUTOMOTIVE GRP INC COM	COM	70959W103	3233	67100	SH	SOLE	67100	0	0
PENUMBRA INC COM	COM	70975L107	74641	982244	SH	SOLE	962663	0	19581
PEPSICO INC COM	COM	713448108	212193	1950840	SH	SOLE	1912222	0	38618
PEPSICO INC COM	COM	713448108	152	1401	SH	OTR	0	0	1401
PERFICIENT INC COM	COM	71375U101	2596	128843	SH	SOLE	128843	0	0
PERFICIENT INC COM	COM	71375U101	600	29785	SH	OTR	29785	0	0
PERFORMANCE FOOD GROUP CO COM	COM	71377A103	36824	1484823	SH	SOLE	1444798	0	40025
PERKINELMER INC COM	COM	714046109	81553	1453449	SH	SOLE	1375781	0	77668
PETMED EXPRESS INC COM	COM	716382106	2167	106831	SH	SOLE	106831	0	0
PETMED EXPRESS INC COM	COM	716382106	503	24803	SH	OTR	24803	0	0
PFIZER INC COM	COM	717081103	407652	12035773	SH	SOLE	11863477	0	172296
PFIZER INC COM	COM	717081103	201	5922	SH	OTR	0	0	5922
PHYSICIANS RLTY TR COM	COM	71943U104	94866	4404166	SH	SOLE	4151247	0	252919
PILGRIMS PRIDE CORP NEW COM	COM	72147K108	3641	172400	SH	SOLE	172400	0	0
PINNACLE WEST CAP CORP COM	COM	723484101	10031	132000	SH	SOLE	132000	0	0
PINNACLE FOODS INC DEL COM	COM	72348P104	119766	2387207	SH	SOLE	2271078	0	116129
PIONEER NAT RES CO COM	COM	723787107	9932	53500	SH	SOLE	53500	0	0
PITNEY BOWES INC COM	COM	724479100	20706	1140200	SH	SOLE	1140200	0	0
PLANET FITNESS INC CL A	COM	72703H101	43790	2181862	SH	SOLE	2126317	0	55545
PLANTRONICS INC NEW COM	COM	727493108	16554	318589	SH	SOLE	318589	0	0
POLYONE CORP COM	COM	73179P106	15206	449737	SH	SOLE	449737	0	0
POOL CORPORATION COM	COM	73278L105	45987	486536	SH	SOLE	477342	0	9194
PORTLAND GEN ELEC CO COM NEW	COM	736508847	72184	1694859	SH	SOLE	1690515	0	4344
POTLATCH CORP NEW COM	COM	737630103	11681	300350	SH	SOLE	300350	0	0
PRESTIGE BRANDS HLDGS INC COM	COM	74112D101	29687	615029	SH	SOLE	571502	0	43527
PRICE T ROWE GROUP INC COM	COM	74144T108	19584	294500	SH	SOLE	294500	0	0
PRICELINE GRP INC COM NEW	COM	741503403	22367	15200	SH	SOLE	15200	0	0
PRICELINE GRP INC NOTE 1.000% 3/1	CV	741503AQ9	5906	3720000	PRN	SOLE	3720000	0	0
PRICELINE GRP INC NOTE 0.350% 6/1	CV	741503AS5	19720	15346000	PRN	SOLE	15346000	0	0
PRIMORIS SVCS CORP COM	COM	74164F103	18272	886972	SH	SOLE	886972	0	0
PRINCIPAL FINL GROUP INC COM	COM	74251V102	3874	75200	SH	SOLE	75200	0	0
PROCTER AND GAMBLE CO COM	COM	742718109	130864	1458100	SH	SOLE	1458100	0	0
PROLOGIS INC COM	COM	74340W103	66352	1239300	SH	SOLE	1239300	0	0
PROOFPOINT INC COM	COM	743424103	58516	781777	SH	SOLE	765211	0	16566
PROOFPOINT INC NOTE 1.250%12/1	CV	743424AB9	15718	8123000	PRN	SOLE	8123000	0	0
PROOFPOINT INC DBCV 0.750% 6/1	CV	743424AD5	3534	3043000	PRN	SOLE	3043000	0	0
PRUDENTIAL FINL INC COM	COM	744320102	107427	1315700	SH	SOLE	1315700	0	0
PUBLIC SVC ENTERPRISE GROUP COM	COM	744573106	11116	265500	SH	SOLE	265500	0	0
QUAKER CHEM CORP COM	COM	747316107	2733	25800	SH	SOLE	25800	0	0
QTS RLTY TR INC COM CL A	COM	74736A103	9775	184956	SH	SOLE	184956	0	0
QUALCOMM INC COM	COM	747525103	365231	5331834	SH	SOLE	5270712	0	61122
QUALCOMM INC COM	COM	747525103	148	2162	SH	OTR	0	0	2162
QUEST DIAGNOSTICS INC COM	COM	74834L100	26091	308300	SH	SOLE	308300	0	0
RPC INC COM	COM	749660106	1294	77000	SH	SOLE	77000	0	0
RPM INTL INC COM	COM	749685103	56240	1046905	SH	SOLE	998835	0	48070
RPM INTL INC NOTE 2.250%12/1	CV	749685AT0	5468	4545000	PRN	SOLE	4545000	0	0
RTI INTL METALS INC NOTE 1.625%10/1	CV	74973WAB3	13303	12418000	PRN	SOLE	12418000	0	0
RALPH LAUREN CORP CL A	COM	751212101	30247	299056	SH	SOLE	276718	0	22338
RANGE RES CORP COM	COM	75281A109	35839	924869	SH	SOLE	924869	0	0
RAYTHEON CO COM NEW	COM	755111507	103322	758996	SH	SOLE	758996	0	0
RBC BEARINGS INC COM	COM	75524B104	1492	19507	SH	SOLE	19032	0	475
RE MAX HLDGS INC CL A	COM	75524W108	4216	96294	SH	SOLE	96294	0	0
REALOGY HLDGS CORP COM	COM	75605Y106	26011	1005820	SH	SOLE	940694	0	65126
REALTY INCOME CORP COM	COM	756109104	3869	57800	SH	SOLE	57800	0	0
RED HAT INC COM	COM	756577102	11678	144479	SH	SOLE	144479	0	0
RED HAT INC NOTE 0.250%10/0	CV	756577AD4	3050	2400000	PRN	SOLE	2400000	0	0
REGENCY CTRS CORP COM	COM	758849103	19132	246900	SH	SOLE	246900	0	0
REGENERON PHARMACEUTICALS COM	COM	75886F107	5828	14497	SH	SOLE	14497	0	0
REINSURANCE GROUP AMER INC COM NEW	COM	759351604	23110	214098	SH	SOLE	214098	0	0
RELIANCE STEEL  ALUMINUM CO COM	COM	759509102	96256	1336337	SH	SOLE	1254841	0	81496
RENASANT CORP COM	COM	75970E107	18857	560709	SH	SOLE	560709	0	0
REPLIGEN CORP COM	COM	759916109	4976	164832	SH	SOLE	164832	0	0
REPLIGEN CORP COM	COM	759916109	1157	38333	SH	OTR	38333	0	0
REPLIGEN CORP NOTE 2.125% 6/0	CV	759916AA7	3487	3050000	PRN	SOLE	3050000	0	0
REPUBLIC SVCS INC COM	COM	760759100	12951	256700	SH	SOLE	256700	0	0
RETAIL OPPORTUNITY INVTS COR COM	COM	76131N101	83230	3790055	SH	SOLE	3593679	0	196376
REYNOLDS AMERICAN INC COM	COM	761713106	141756	3006500	SH	SOLE	3006500	0	0
RICE ENERGY INC COM	COM	762760106	100070	3832620	SH	SOLE	3639564	0	193056
RIO TINTO PLC SPONSORED ADR	ADR	767204100	28754	860904	SH	SOLE	857832	0	3072
RIO TINTO PLC SPONSORED ADR	ADR	767204100	9	271	SH	OTR	0	0	271
ROBERT HALF INTL INC COM	COM	770323103	14716	388700	SH	SOLE	388700	0	0
ROCKWELL AUTOMATION INC COM	COM	773903109	8032	65651	SH	SOLE	65651	0	0
ROPER TECHNOLOGIES INC COM	COM	776696106	4872	26698	SH	SOLE	26698	0	0
ROSS STORES INC COM	COM	778296103	12590	195800	SH	SOLE	195800	0	0
ROYAL BK SCOTLAND GROUP PLC NOTE 8.625%12/3	CV	780097BB6	19625	20000000	PRN	SOLE	19795000	0	205000
ROYAL BK OF SCOTLAND PLC DEBT 7.500%12/3	CV	780099CJ4	27203	29569000	PRN	SOLE	29369000	0	200000
ROYAL DUTCH SHELL PLC SPONS ADR A	ADR	780259206	22371	446791	SH	SOLE	445154	0	1637
ROYAL DUTCH SHELL PLC SPONS ADR A	ADR	780259206	7	145	SH	OTR	0	0	145
ROYAL GOLD INC NOTE 2.875% 6/1	CV	780287AA6	21244	18936000	PRN	SOLE	18936000	0	0
RUSH ENTERPRISES INC CL A	COM	781846209	1777	72600	SH	SOLE	72600	0	0
RYDER SYS INC COM	COM	783549108	4630	70200	SH	SOLE	70200	0	0
SP GLOBAL INC COM	COM	78409V104	22486	177670	SH	SOLE	177670	0	0
SEI INVESTMENTS CO COM	COM	784117103	13450	294900	SH	SOLE	294900	0	0
SL GREEN RLTY CORP COM	COM	78440X101	20561	190200	SH	SOLE	190200	0	0
SM ENERGY CO NOTE 1.500% 7/0	CV	78454LAM2	13737	11400000	PRN	SOLE	11400000	0	0
SVB FINL GROUP COM	COM	78486Q101	13011	117700	SH	SOLE	117700	0	0
SABRE CORP COM	COM	78573M104	9431	334668	SH	SOLE	334668	0	0
SAGE THERAPEUTICS INC COM	COM	78667J108	30357	659218	SH	SOLE	643764	0	15454
SAGE THERAPEUTICS INC COM	COM	78667J108	913	19830	SH	OTR	19830	0	0
SALESFORCE COM INC NOTE 0.250% 4/0	CV	79466LAD6	10523	8783000	PRN	SOLE	8783000	0	0
SAREPTA THERAPEUTICS INC COM	COM	803607100	18550	302070	SH	SOLE	294399	0	7671
SCANA CORP NEW COM	COM	80589M102	65762	908695	SH	SOLE	908695	0	0
SCHEIN HENRY INC COM	COM	806407102	6380	39145	SH	SOLE	39145	0	0
SCHLUMBERGER LTD COM	COM	806857108	61054	776370	SH	SOLE	776370	0	0
SCHWAB CHARLES CORP NEW COM	COM	808513105	2065	65400	SH	SOLE	65400	0	0
SCOTTS MIRACLE GRO CO CL A	COM	810186106	13989	168000	SH	SOLE	168000	0	0
SEALED AIR CORP NEW COM	COM	81211K100	51744	1129279	SH	SOLE	1047197	0	82082
SEATTLE GENETICS INC COM	COM	812578102	18589	344174	SH	SOLE	344174	0	0
SEMPRA ENERGY COM	COM	816851109	124488	1161380	SH	SOLE	1158802	0	2578
SEMPRA ENERGY COM	COM	816851109	30	283	SH	OTR	0	0	283
SERVICENOW INC COM	COM	81762P102	15226	192375	SH	SOLE	192375	0	0
SHAKE SHACK INC CL A	COM	819047101	23342	673253	SH	SOLE	665986	0	7267
SHOPIFY INC CL A	COM	82509L107	71467	1665122	SH	SOLE	1636019	0	29103
SHUTTERSTOCK INC COM	COM	825690100	52047	817065	SH	SOLE	801521	0	15544
SIGNATURE BK NEW YORK N Y COM	COM	82669G104	2109	17809	SH	SOLE	16347	0	1462
SIGNATURE BK NEW YORK N Y COM	COM	82669G104	28	235	SH	OTR	0	0	235
SILICON MOTION TECHNOLOGY CO SPONSORED ADR	ADR	82706C108	54583	1053933	SH	SOLE	1035999	0	17934
SILVER RUN ACQUISITION CORP UNIT 99/99/9999T	COM	82811P200	23250	1290924	SH	SOLE	1290924	0	0
SILVER SPRING NETWORKS INC COM	COM	82817Q103	4046	285357	SH	SOLE	285357	0	0
SILVER SPRING NETWORKS INC COM	COM	82817Q103	934	65872	SH	OTR	65872	0	0
SILVER WHEATON CORP COM	COM	828336107	10131	374823	SH	SOLE	374823	0	0
SIMON PPTY GROUP INC NEW COM	COM	828806109	3514	16977	SH	SOLE	16977	0	0
SIMPSON MANUFACTURING CO INC COM	COM	829073105	6065	138000	SH	SOLE	138000	0	0
SITEONE LANDSCAPE SUPPLY INC COM	COM	82982L103	12111	337084	SH	SOLE	335266	0	1818
SKYWORKS SOLUTIONS INC COM	COM	83088M102	37471	492132	SH	SOLE	492132	0	0
SMITH A O COM	COM	831865209	44825	453738	SH	SOLE	453738	0	0
SMUCKER J M CO COM NEW	COM	832696405	4405	32500	SH	SOLE	32500	0	0
SNYDERS-LANCE INC COM	COM	833551104	26353	784789	SH	SOLE	784789	0	0
SOUTH ST CORP COM	COM	840441109	15688	209068	SH	SOLE	209068	0	0
SOUTHWESTERN ENERGY CO DEP SHS 1/20 B	CVPFD	845467208	30348	961302	SH	SOLE	961302	0	0
SPARK THERAPEUTICS INC COM	COM	84652J103	64568	1075059	SH	SOLE	1057771	0	17288
SPARK THERAPEUTICS INC COM	COM	84652J103	508	8458	SH	OTR	8458	0	0
SPECTRANETICS CORP COM	COM	84760C107	8009	319214	SH	SOLE	319214	0	0
SPECTRANETICS CORP COM	COM	84760C107	1859	74076	SH	OTR	74076	0	0
SPLUNK INC COM	COM	848637104	8552	145742	SH	SOLE	145742	0	0
STAMPS COM INC COM NEW	COM	852857200	18728	198161	SH	SOLE	193039	0	5122
STANLEY BLACK  DECKER INC COM	COM	854502101	7453	60600	SH	SOLE	60600	0	0
STANLEY BLACK  DECKER INC UNIT 11/17/20166	CVPFD	854502804	5337	42246	SH	SOLE	42246	0	0
STARWOOD PPTY TR INC COM	COM	85571B105	3398	150900	SH	SOLE	150900	0	0
STARWOOD PPTY TR INC NOTE 3.750%10/1	CV	85571BAC9	5054	4889000	PRN	SOLE	4889000	0	0
STEEL DYNAMICS INC COM	COM	858119100	57836	2314377	SH	SOLE	2314377	0	0
STERICYCLE INC COM	COM	858912108	6662	83134	SH	SOLE	83134	0	0
STILLWATER MNG CO NOTE 1.750%10/1	CV	86074QAL6	10085	8369000	PRN	SOLE	8369000	0	0
STONERIDGE INC COM	COM	86183P102	3991	216918	SH	SOLE	216918	0	0
STONERIDGE INC COM	COM	86183P102	914	49687	SH	OTR	49687	0	0
SUMITOMO MITSUI FINL GROUP I SPONSORED ADR	ADR	86562M209	143	21239	SH	SOLE	10787	0	10452
SUMITOMO MITSUI FINL GROUP I SPONSORED ADR	ADR	86562M209	6	918	SH	OTR	0	0	918
SUNPOWER CORP DBCV 0.750% 6/0	CV	867652AG4	8764	9565000	PRN	SOLE	9565000	0	0
SUPERIOR ENERGY SVCS INC COM	COM	868157108	41299	2307230	SH	SOLE	2307230	0	0
SURGICAL CARE AFFILIATES INC COM	COM	86881L106	3414	70010	SH	SOLE	70010	0	0
SYNAPTICS INC COM	COM	87157D109	60483	1032480	SH	SOLE	979483	0	52997
SYSCO CORP COM	COM	871829107	41659	850000	SH	SOLE	850000	0	0
TD AMERITRADE HLDG CORP COM	COM	87236Y108	135073	3832951	SH	SOLE	3751185	0	81766
TD AMERITRADE HLDG CORP COM	COM	87236Y108	87	2481	SH	OTR	0	0	2481
TJX COS INC NEW COM	COM	872540109	26208	350473	SH	SOLE	350473	0	0
T MOBILE US INC COM	COM	872590104	10557	225961	SH	SOLE	225961	0	0
T MOBILE US INC CONV PFD SER A	CVPFD	872590203	16143	206771	SH	SOLE	206771	0	0
TPI COMPOSITES INC COM	COM	87266J104	1225	57606	SH	SOLE	57606	0	0
TPI COMPOSITES INC COM	COM	87266J104	285	13388	SH	OTR	13388	0	0
TAKE-TWO INTERACTIVE SOFTWAR NOTE 1.000% 7/0	CV	874054AD1	23399	11129000	PRN	SOLE	11129000	0	0
TALEND S A ADS	ADR	874224207	5828	222798	SH	SOLE	222798	0	0
TALEND S A ADS	ADR	874224207	874	33413	SH	OTR	33413	0	0
TARGET CORP COM	COM	87612E106	66808	972747	SH	SOLE	972747	0	0
TASER INTL INC COM	COM	87651B104	43754	1529331	SH	SOLE	1492667	0	36664
TASER INTL INC COM	COM	87651B104	506	17695	SH	OTR	17695	0	0
TECK RESOURCES LTD CL B	COM	878742204	10091	559689	SH	SOLE	559689	0	0
TEGNA INC COM	COM	87901J105	6938	317400	SH	SOLE	317400	0	0
TELEDYNE TECHNOLOGIES INC COM	COM	879360105	15147	140339	SH	SOLE	140339	0	0
TESARO INC COM	COM	881569107	83808	836070	SH	SOLE	821906	0	14164
TESARO INC NOTE 3.000%10/0	CV	881569AA5	7049	2396000	PRN	SOLE	2396000	0	0
TESORO CORP COM	COM	881609101	6134	77100	SH	SOLE	77100	0	0
TESLA MTRS INC NOTE 0.250% 3/0	CV	88160RAB7	44966	49345000	PRN	SOLE	49345000	0	0
TEVA PHARMACEUTICAL INDS LTD ADR	ADR	881624209	2238	48648	SH	SOLE	47342	0	1306
TEVA PHARMACEUTICAL INDS LTD ADR	ADR	881624209	5	109	SH	OTR	0	0	109
TEXAS CAPITAL BANCSHARES INC COM	COM	88224Q107	11602	211250	SH	SOLE	211250	0	0
TEXAS INSTRS INC COM	COM	882508104	38101	542900	SH	SOLE	542900	0	0
THE TRADE DESK INC COM CL A	COM	88339J105	3601	123284	SH	SOLE	121365	0	1919
THE TRADE DESK INC COM CL A	COM	88339J105	350	11977	SH	OTR	11977	0	0
THERMO FISHER SCIENTIFIC INC COM	COM	883556102	56281	353835	SH	SOLE	341403	0	12432
THERMO FISHER SCIENTIFIC INC COM	COM	883556102	54	337	SH	OTR	0	0	337
THOR INDS INC COM	COM	885160101	73168	863852	SH	SOLE	828351	0	35501
3M CO COM	COM	88579Y101	68379	388009	SH	SOLE	388009	0	0
TIFFANY  CO NEW COM	COM	886547108	4757	65500	SH	SOLE	65500	0	0
TIME WARNER INC COM NEW	COM	887317303	106431	1336899	SH	SOLE	1293957	0	42942
TIME WARNER INC COM NEW	COM	887317303	117	1473	SH	OTR	0	0	1473
TIMKEN CO COM	COM	887389104	2520	71700	SH	SOLE	71700	0	0
TIMKENSTEEL CORP NOTE 6.000% 6/0	CV	887399AA1	5050	4575000	PRN	SOLE	4575000	0	0
TOLL BROTHERS INC COM	COM	889478103	3485	116700	SH	SOLE	116700	0	0
TORO CO COM	COM	891092108	14948	319122	SH	SOLE	319122	0	0
TORONTO DOMINION BK ONT NOTE 3.625% 9/1	CV	891160MJ9	15067	15000000	PRN	SOLE	14371000	0	629000
TOTAL S A SPONSORED ADR	ADR	89151E109	9294	194847	SH	SOLE	193682	0	1165
TOTAL S A SPONSORED ADR	ADR	89151E109	5	108	SH	OTR	0	0	108
TRACTOR SUPPLY CO COM	COM	892356106	9298	138056	SH	SOLE	138056	0	0
TRANSDIGM GROUP INC COM	COM	893641100	7936	27449	SH	SOLE	27449	0	0
TRANSUNION COM	COM	89400J107	48399	1402875	SH	SOLE	1382838	0	20037
TRIMBLE NAVIGATION LTD COM	COM	896239100	34105	1194145	SH	SOLE	1194145	0	0
TRINITY INDS INC NOTE 3.875% 6/0	CV	896522AF6	11238	9365000	PRN	SOLE	9365000	0	0
TUPPERWARE BRANDS CORP COM	COM	899896104	18689	285900	SH	SOLE	285900	0	0
TWENTY FIRST CENTY FOX INC CL A	COM	90130A101	1196	49400	SH	SOLE	49400	0	0
TWILIO INC CL A	COM	90138F102	19296	299815	SH	SOLE	294504	0	5311
II VI INC COM	COM	902104108	5840	240035	SH	SOLE	240035	0	0
II VI INC COM	COM	902104108	1351	55512	SH	OTR	55512	0	0
2U INC COM	COM	90214J101	84826	2215346	SH	SOLE	2177051	0	38295
2U INC COM	COM	90214J101	536	14009	SH	OTR	14009	0	0
TYLER TECHNOLOGIES INC COM	COM	902252105	10466	61125	SH	SOLE	61125	0	0
TYSON FOODS INC CL A	COM	902494103	14837	198700	SH	SOLE	198700	0	0
TYSON FOODS INC UNIT 99/99/9999	CVPFD	902494301	7586	92669	SH	SOLE	92669	0	0
UDR INC COM	COM	902653104	53474	1485814	SH	SOLE	1485814	0	0
UGI CORP NEW COM	COM	902681105	12932	285850	SH	SOLE	285850	0	0
U S CONCRETE INC COM NEW	COM	90333L201	5929	128701	SH	SOLE	128701	0	0
U S CONCRETE INC COM NEW	COM	90333L201	991	21506	SH	OTR	21506	0	0
U S PHYSICAL THERAPY INC COM	COM	90337L108	6774	108039	SH	SOLE	108039	0	0
U S PHYSICAL THERAPY INC COM	COM	90337L108	1552	24747	SH	OTR	24747	0	0
U S SILICA HLDGS INC COM	COM	90346E103	25063	538296	SH	SOLE	538296	0	0
ULTA SALON COSMETCS  FRAG I COM	COM	90384S303	33623	141285	SH	SOLE	141285	0	0
ULTIMATE SOFTWARE GROUP INC COM	COM	90385D107	38065	186237	SH	SOLE	182580	0	3657
ULTRAGENYX PHARMACEUTICAL IN COM	COM	90400D108	11150	157176	SH	SOLE	153086	0	4090
UNION PAC CORP COM	COM	907818108	65589	672500	SH	SOLE	672500	0	0
UNITED TECHNOLOGIES CORP COM	COM	913017109	150886	1485100	SH	SOLE	1485100	0	0
UNITEDHEALTH GROUP INC COM	COM	91324P102	132421	945866	SH	SOLE	924935	0	20931
UNITEDHEALTH GROUP INC COM	COM	91324P102	105	748	SH	OTR	0	0	748
UNIVERSAL DISPLAY CORP COM	COM	91347P105	16657	300066	SH	SOLE	292258	0	7808
UNIVERSAL ELECTRS INC COM	COM	913483103	26350	353886	SH	SOLE	347657	0	6229
UNIVERSAL ELECTRS INC COM	COM	913483103	1925	25853	SH	OTR	25853	0	0
UNIVERSAL FST PRODS INC COM	COM	913543104	5802	58911	SH	SOLE	58911	0	0
UNUM GROUP COM	COM	91529Y106	28894	818300	SH	SOLE	818300	0	0
VCA INC COM	COM	918194101	29324	419033	SH	SOLE	412614	0	6419
V F CORP COM	COM	918204108	10280	183400	SH	SOLE	183400	0	0
VAIL RESORTS INC COM	COM	91879Q109	63776	406526	SH	SOLE	403128	0	3398
VALERO ENERGY CORP NEW COM	COM	91913Y100	77536	1462950	SH	SOLE	1462950	0	0
VANECK VECTORS ETF TR JR GOLD MINERS E	ETF	92189F791	12081	272778	SH	SOLE	272778	0	0
VANTIV INC CL A	COM	92210H105	43742	777365	SH	SOLE	730326	0	47039
VASCULAR SOLUTIONS INC COM	COM	92231M109	8895	184435	SH	SOLE	184435	0	0
VASCULAR SOLUTIONS INC COM	COM	92231M109	2061	42733	SH	OTR	42733	0	0
VEEVA SYS INC CL A COM	COM	922475108	119451	2893669	SH	SOLE	2853836	0	39833
VENTAS INC COM	COM	92276F100	12290	174000	SH	SOLE	174000	0	0
VERISIGN INC SDCV 3.250% 8/1	CV	92343EAD4	23460	10214000	PRN	SOLE	10214000	0	0
VERIZON COMMUNICATIONS INC COM	COM	92343V104	186317	3584406	SH	SOLE	3568928	0	15478
VERSUM MATLS INC COM	COM	92532W103	8524	375500	SH	SOLE	375500	0	0
VIPSHOP HLDGS LTD NOTE 1.500% 3/1	CV	92763WAA1	9734	9003000	PRN	SOLE	9003000	0	0
VISA INC COM CL A	COM	92826C839	60392	730257	SH	SOLE	730257	0	0
VISHAY PRECISION GROUP INC COM	COM	92835K103	2349	146512	SH	SOLE	146512	0	0
VORNADO RLTY TR SH BEN INT	COM	929042109	95269	941304	SH	SOLE	919910	0	21394
VORNADO RLTY TR SH BEN INT	COM	929042109	84	828	SH	OTR	0	0	828
VOYA FINL INC COM	COM	929089100	3225	111900	SH	SOLE	111900	0	0
VULCAN MATLS CO COM	COM	929160109	25576	224885	SH	SOLE	224885	0	0
WD-40 CO COM	COM	929236107	3587	31903	SH	SOLE	31903	0	0
WEC ENERGY GROUP INC COM	COM	92939U106	82988	1385900	SH	SOLE	1385900	0	0
WABTEC CORP COM	COM	929740108	51828	634754	SH	SOLE	596080	0	38674
WAGEWORKS INC COM	COM	930427109	67569	1109321	SH	SOLE	1088101	0	21220
WAL-MART STORES INC COM	COM	931142103	117098	1623650	SH	SOLE	1623650	0	0
WALGREENS BOOTS ALLIANCE INC COM	COM	931427108	129269	1603440	SH	SOLE	1603440	0	0
WATSCO INC COM	COM	942622200	36320	257770	SH	SOLE	254148	0	3622
WAYFAIR INC CL A	COM	94419L101	22615	574426	SH	SOLE	559439	0	14987
WEATHERFORD INTL LTD NOTE 5.875% 7/0	CV	947075AH0	7019	6243000	PRN	SOLE	6243000	0	0
WEB COM GROUP INC NOTE 1.000% 8/1	CV	94733AAA2	14589	15286000	PRN	SOLE	15286000	0	0
WEBSTER FINL CORP CONN COM	COM	947890109	141657	3726836	SH	SOLE	3594152	0	132684
WEBSTER FINL CORP CONN COM	COM	947890109	92	2424	SH	OTR	0	0	2424
WEIBO CORP SPONSORED ADR	ADR	948596101	10780	215000	SH	SOLE	215000	0	0
WELLS FARGO  CO NEW COM	COM	949746101	17942	405197	SH	SOLE	389359	0	15838
WELLS FARGO  CO NEW COM	COM	949746101	107	2423	SH	OTR	0	0	2423
WELLS FARGO  CO NEW PERP PFD CNV A	CVPFD	949746804	35733	27306	SH	SOLE	27306	0	0
WELLTOWER INC COM	COM	95040Q104	3552	47500	SH	SOLE	47500	0	0
WEST PHARMACEUTICAL SVSC INC COM	COM	955306105	25550	342950	SH	SOLE	342950	0	0
WESTERN ALLIANCE BANCORP COM	COM	957638109	110870	2953379	SH	SOLE	2803972	0	149407
WESTERN UN CO COM	COM	959802109	47307	2272200	SH	SOLE	2272200	0	0
WESTROCK CO COM	COM	96145D105	69708	1437878	SH	SOLE	1377564	0	60314
WHIRLPOOL CORP COM	COM	963320106	140068	863765	SH	SOLE	863765	0	0
WHITING PETE CORP NEW COM	COM	966387102	1504	172100	SH	SOLE	172100	0	0
WILLIAMS COS INC DEL COM	COM	969457100	59186	1925994	SH	SOLE	1925994	0	0
WINGSTOP INC COM	COM	974155103	5757	196482	SH	SOLE	196482	0	0
WINGSTOP INC COM	COM	974155103	1319	45006	SH	OTR	45006	0	0
WISDOMTREE INVTS INC COM	COM	97717P104	8571	832984	SH	SOLE	810931	0	22053
WISDOMTREE TR JAPN HEDGE EQT	ETF	97717W851	46330	1079710	SH	SOLE	1079710	0	0
WORKDAY INC CL A	COM	98138H101	17226	187867	SH	SOLE	187867	0	0
WORKDAY INC NOTE 0.750% 7/1	CV	98138HAC5	2471	2000000	PRN	SOLE	2000000	0	0
WORKDAY INC NOTE 1.500% 7/1	CV	98138HAD3	9552	7337000	PRN	SOLE	7337000	0	0
WORTHINGTON INDS INC COM	COM	981811102	15055	313440	SH	SOLE	313440	0	0
WPX ENERGY INC COM	COM	98212B103	14934	1132229	SH	SOLE	1132229	0	0
WPX ENERGY INC PFD SER A CV	CVPFD	98212B202	6539	105144	SH	SOLE	105144	0	0
WRIGHT MED GROUP INC NOTE 2.000% 2/1	CV	98235TAE7	12090	11266000	PRN	SOLE	11266000	0	0
WYNDHAM WORLDWIDE CORP COM	COM	98310W108	19537	290168	SH	SOLE	290168	0	0
WYNN RESORTS LTD COM	COM	983134107	61408	630343	SH	SOLE	630343	0	0
XACTLY CORP COM	COM	98386L101	4725	321022	SH	SOLE	321022	0	0
XACTLY CORP COM	COM	98386L101	1091	74129	SH	OTR	74129	0	0
XCEL ENERGY INC COM	COM	98389B100	3690	89700	SH	SOLE	89700	0	0
XENCOR INC COM	COM	98401F105	3454	141021	SH	SOLE	141021	0	0
XENCOR INC COM	COM	98401F105	803	32795	SH	OTR	32795	0	0
XEROX CORP COM	COM	984121103	38703	3820597	SH	SOLE	3820597	0	0
XYLEM INC COM	COM	98419M100	11342	216245	SH	SOLE	216245	0	0
YAHOO INC NOTE 12/0	CV	984332AF3	34680	33711000	PRN	SOLE	33711000	0	0
YUM BRANDS INC COM	COM	988498101	59775	658241	SH	SOLE	637543	0	20698
YUM BRANDS INC COM	COM	988498101	67	742	SH	OTR	0	0	742
ZAYO GROUP HLDGS INC COM	COM	98919V105	78831	2653359	SH	SOLE	2456932	0	196427
ZELTIQ AESTHETICS INC COM	COM	98933Q108	97397	2483361	SH	SOLE	2437224	0	46137
ZELTIQ AESTHETICS INC COM	COM	98933Q108	1216	31015	SH	OTR	31015	0	0
ZENDESK INC COM	COM	98936J101	67766	2206634	SH	SOLE	2163277	0	43357
ZIMMER BIOMET HLDGS INC COM	COM	98956P102	8048	61900	SH	SOLE	61900	0	0
ZOETIS INC CL A	COM	98978V103	14234	273681	SH	SOLE	273681	0	0
ALLEGION PUB LTD CO ORD SHS	COM	G0176J109	8838	128254	SH	SOLE	128254	0	0
ALLERGAN PLC SHS	COM	G0177J108	44747	194290	SH	SOLE	187450	0	6840
ALLERGAN PLC SHS	COM	G0177J108	72	313	SH	OTR	0	0	313
ALLERGAN PLC PFD CONV SER A	CVPFD	G0177J116	32126	39100	SH	SOLE	39100	0	0
AMDOCS LTD SHS	COM	G02602103	57792	998994	SH	SOLE	925032	0	73962
AMBARELLA INC SHS	COM	G037AX101	30103	408947	SH	SOLE	398396	0	10551
ARCH CAP GROUP LTD ORD	COM	G0450A105	107009	1350096	SH	SOLE	1273237	0	76859
ARGO GROUP INTL HLDGS LTD COM	COM	G0464B107	15275	270742	SH	SOLE	270742	0	0
ARRIS INTL INC SHS	COM	G0551A103	67289	2375193	SH	SOLE	2227201	0	147992
ATLASSIAN CORP PLC CL A	COM	G06242104	71565	2387887	SH	SOLE	2355424	0	32463
AXIS CAPITAL HOLDINGS LTD SHS	COM	G0692U109	7367	135600	SH	SOLE	135600	0	0
ACCENTURE PLC IRELAND SHS CLASS A	COM	G1151C101	68394	559824	SH	SOLE	559824	0	0
MIMECAST LTD ORD SHS	COM	G14838109	2716	142000	SH	SOLE	142000	0	0
MIMECAST LTD ORD SHS	COM	G14838109	631	33000	SH	OTR	33000	0	0
BUNGE LIMITED COM	COM	G16962105	31596	533452	SH	SOLE	533452	0	0
CARDTRONICS PLC SHS CL A	COM	G1991C105	75098	1683805	SH	SOLE	1603779	0	80026
COCA COLA EUROPEAN PARTNERS SHS	COM	G25839104	38104	954982	SH	SOLE	952508	0	2474
COCA COLA EUROPEAN PARTNERS SHS	COM	G25839104	9	214	SH	OTR	0	0	214
EATON CORP PLC SHS	COM	G29183103	100050	1522600	SH	SOLE	1522600	0	0
ENDURANCE SPECIALTY HLDGS LT SHS	COM	G30397106	28548	436178	SH	SOLE	436178	0	0
ESSENT GROUP LTD COM	COM	G3198U102	53180	1998490	SH	SOLE	1887828	0	110662
EVEREST RE GROUP LTD COM	COM	G3223R108	8910	46900	SH	SOLE	46900	0	0
FABRINET SHS	COM	G3323L100	4143	92904	SH	SOLE	92904	0	0
FABRINET SHS	COM	G3323L100	957	21453	SH	OTR	21453	0	0
GASLOG LTD SHS	COM	G37585109	40067	2753771	SH	SOLE	2690670	0	63101
GASLOG LTD SHS	COM	G37585109	1025	70416	SH	OTR	70416	0	0
INGERSOLL-RAND PLC SHS	COM	G47791101	44566	655957	SH	SOLE	655957	0	0
INVESCO LTD SHS	COM	G491BT108	157572	5039064	SH	SOLE	5003078	0	35986
JAMES RIV GROUP LTD COM	COM	G5005R107	6101	168543	SH	SOLE	168543	0	0
JOHNSON CTLS INTL PLC SHS	COM	G51502105	111416	2394505	SH	SOLE	2394505	0	0
MALLINCKRODT PUB LTD CO SHS	COM	G5785G107	46213	662273	SH	SOLE	662273	0	0
MEDTRONIC PLC SHS	COM	G5960L103	121115	1401794	SH	SOLE	1401794	0	0
NIELSEN HLDGS PLC SHS EUR	COM	G6518L108	7364	137472	SH	SOLE	137472	0	0
NORWEGIAN CRUISE LINE HLDGS SHS	COM	G66721104	10203	270631	SH	SOLE	270631	0	0
RENAISSANCERE HOLDINGS LTD COM	COM	G7496G103	113492	944511	SH	SOLE	894326	0	50185
ROWAN COMPANIES PLC SHS CL A	COM	G7665A101	11491	758000	SH	SOLE	758000	0	0
PENTAIR PLC SHS	COM	G7S00T104	28773	447900	SH	SOLE	447900	0	0
STERIS PLC SHS USD	COM	G84720104	60943	833691	SH	SOLE	784715	0	48976
VALIDUS HOLDINGS LTD COM SHS	COM	G9319H102	2914	58500	SH	SOLE	58500	0	0
XL GROUP LTD COM	COM	G98294104	123826	3682023	SH	SOLE	3682023	0	0
ALLIED WRLD ASSUR COM HLDG A SHS	COM	H01531104	31096	769310	SH	SOLE	769310	0	0
CHUBB LIMITED COM	COM	H1467J104	183235	1458299	SH	SOLE	1418025	0	40274
CHUBB LIMITED COM	COM	H1467J104	188	1496	SH	OTR	0	0	1496
GLOBANT S A COM	COM	L44385109	3162	75072	SH	SOLE	75072	0	0
GLOBANT S A COM	COM	L44385109	730	17335	SH	OTR	17335	0	0
TRINSEO S A SHS	COM	L9340P101	51262	906338	SH	SOLE	853542	0	52796
CYBERARK SOFTWARE LTD SHS	COM	M2682V108	4179	84315	SH	SOLE	84315	0	0
MELLANOX TECHNOLOGIES LTD SHS	COM	M51363113	8679	200660	SH	SOLE	195424	0	5236
ORBOTECH LTD ORD	COM	M75253100	39039	1318430	SH	SOLE	1318430	0	0
WIX COM LTD SHS	COM	M98068105	76107	1752403	SH	SOLE	1713609	0	38794
WIX COM LTD SHS	COM	M98068105	1076	24777	SH	OTR	24777	0	0
CIMPRESS N V SHS EURO	COM	N20146101	18679	184616	SH	SOLE	179837	0	4779
MOBILEYE N V AMSTELVEEN ORD SHS	COM	N51488117	10211	239860	SH	SOLE	239860	0	0
LYONDELLBASELL INDUSTRIES N SHS - A -	COM	N53745100	106596	1321550	SH	SOLE	1294567	0	26983
LYONDELLBASELL INDUSTRIES N SHS - A -	COM	N53745100	59	729	SH	OTR	0	0	729
PATHEON N V SHS	COM	N6865W105	29817	1006301	SH	SOLE	989440	0	16861
ROYAL CARIBBEAN CRUISES LTD COM	COM	V7780T103	30384	405390	SH	SOLE	405390	0	0
BROADCOM LTD SHS	COM	Y09827109	53855	312165	SH	SOLE	310992	0	1173
